Id,Label,timeset,modularity_class,indegree,outdegree,degree,weighted indegree,weighted outdegree,weighted degree,Eccentricity,closnesscentrality,harmonicclosnesscentrality,betweenesscentrality
enviaxat,enviaxat,,4,5,6,11,5,10,15,10,0.188267,0.229329,1567.657724
Pablo_Iglesias_,Pablo_Iglesias_,,1,6,0,6,8,0,8,0,0,0,0
PDCComarquesBCN,PDCComarquesBCN,,6,0,6,6,0,10,10,12,0.152281,0.194033,0
JordiMonros,JordiMonros,,6,17,13,30,36,22,58,11,0.17681,0.236051,21831.876882
IcsMarta,IcsMarta,,7,0,6,6,0,12,12,3,0.571429,0.708333,0
HansPeterT,HansPeterT,,4,67,2,69,72,2,74,2,0.625,0.7,1263.766667
SoCal_CAT,SoCal_CAT,,2,36,1,37,37,1,38,0,0,0,0
xamfaina61,xamfaina61,,2,0,6,6,0,7,7,11,0.157655,0.192192,0
psiborn,psiborn,,2,246,1,247,414,1,415,1,1,1,47.936601
cristinasamped1,cristinasamped1,,2,0,5,5,0,6,6,9,0.2,0.232868,0
susisanchezval1,susisanchezval1,,4,0,7,7,0,8,8,8,0.239449,0.284618,0
Kking2k6,Kking2k6,,1,4,9,13,5,12,17,10,0.189691,0.234373,3149.523696
MargaXrepublica,MargaXrepublica,,2,37,9,46,42,18,60,9,0.216132,0.25796,16962.857189
JoanHumetB,JoanHumetB,,0,24,7,31,145,41,186,10,0.184,0.224006,1363.466006
Manji130,Manji130,,0,34,19,53,164,49,213,9,0.223844,0.29395,23321.853439
androide_rre,androide_rre,,3,0,19,19,0,36,36,8,0.259777,0.3296,0
jbp2704,jbp2704,,2,0,9,9,0,10,10,10,0.174623,0.21413,0
Albertodelvalle,Albertodelvalle,,6,2,12,14,3,15,18,13,0.124215,0.16796,6.166667
Eli27102017,Eli27102017,,7,1,7,8,1,9,10,9,0.229808,0.267742,2130.184891
OHLen4,OHLen4,,6,0,11,11,0,13,13,9,0.248654,0.307613,0
filumestre,filumestre,,2,0,7,7,0,8,8,8,0.247321,0.293751,0
David_MartinW,David_MartinW,,3,8,8,16,11,8,19,9,0.234494,0.278126,10436.649264
Esterpensativa,Esterpensativa,,2,0,6,6,0,6,6,9,0.200434,0.235575,0
elcaprat,elcaprat,,2,0,9,9,0,9,9,9,0.234797,0.287741,0
aajardi,aajardi,,1,20,8,28,26,8,34,10,0.189171,0.225342,2898.99339
tmanjavacas,tmanjavacas,,5,0,5,5,0,6,6,11,0.140752,0.168023,0
detectanyordos4,detectanyordos4,,6,5,2,7,5,2,7,2,0.666667,0.75,5
CesarLagonigro,CesarLagonigro,,7,224,5,229,255,8,263,12,0.137041,0.164975,22216.320336
Almat49,Almat49,,6,0,7,7,0,9,9,13,0.122621,0.155485,0
NuriaOMahony,NuriaOMahony,,3,9,16,25,10,18,28,9,0.228666,0.292442,10144.04988
montca224,montca224,,7,0,7,7,0,12,12,10,0.182895,0.220357,0
RiTA_clic,RiTA_clic,,0,0,9,9,0,62,62,10,0.18521,0.231388,0
ted_bundy2512,ted_bundy2512,,6,0,9,9,0,11,11,10,0.182959,0.232871,0
mbrugues,mbrugues,,4,0,7,7,0,7,7,9,0.216237,0.258439,0
anaoromi,anaoromi,,1,2,74,76,2,99,101,7,0.448468,0.554481,560.99881
g_carme234,g_carme234,,1,2,18,20,5,19,24,9,0.231331,0.300397,270.977381
manelnn51,manelnn51,,1,0,7,7,0,9,9,10,0.171499,0.207925,0
BfarnosB,BfarnosB,,1,3,3,6,3,3,6,10,0.191667,0.220763,5870.26013
ernest_sant,ernest_sant,,1,36,5,41,54,8,62,2,0.7,0.785714,1268.910504
dari_low,dari_low,,2,0,6,6,0,6,6,10,0.159746,0.188693,0
CobetEnric,CobetEnric,,4,0,5,5,0,9,9,9,0.211774,0.246013,0
aquipuedo,aquipuedo,,4,100,11,111,140,15,155,8,0.26513,0.322843,43623.266552
vjjordanc,vjjordanc,,1,102,1,103,190,27,217,0,0,0,0
jmcaballero58,jmcaballero58,,2,0,7,7,0,12,12,10,0.167777,0.199254,0
alexmane,alexmane,,6,25,0,25,59,0,59,0,0,0,0
dinolentine,dinolentine,,2,25,3,28,27,3,30,1,1,1,749.265293
BritsPro,BritsPro,,3,45,9,54,58,10,68,9,0.207831,0.245761,13902.550239
datilindepe,datilindepe,,1,6,0,6,6,0,6,0,0,0,0
Carrasclet2,Carrasclet2,,4,0,7,7,0,8,8,9,0.187289,0.219913,0
brmgirona,brmgirona,,7,0,5,5,0,6,6,2,0.857143,0.916667,0
NO_OBLID,NO_OBLID,,6,0,9,9,0,12,12,8,0.252269,0.295868,0
wilmaamat,wilmaamat,,1,2,3,5,3,3,6,2,0.615385,0.6875,12.7
RbRoser,RbRoser,,4,22,13,35,33,33,66,8,0.246869,0.30377,10350.931224
Llusa19,Llusa19,,2,0,5,5,0,5,5,3,0.545455,0.666667,0
ciscle,ciscle,,1,1,4,5,1,4,5,4,0.473684,0.648148,8.5
gandhiloquent,gandhiloquent,,0,0,6,6,0,13,13,10,0.184421,0.225003,0
boye_g,boye_g,,1,15,0,15,23,0,23,0,0,0,0
GigiV40687456,GigiV40687456,,6,0,5,5,0,7,7,2,0.777778,0.857143,0
muni1714,muni1714,,2,0,6,6,0,6,6,10,0.166966,0.196451,0
Justsomonelikey,Justsomonelikey,,2,0,7,7,0,10,10,8,0.228926,0.270651,0
isabel57591999,isabel57591999,,6,16,4,20,16,6,22,10,0.180747,0.207918,3179.394448
Montserrat1122,Montserrat1122,,2,0,5,5,0,5,5,10,0.188179,0.22949,0
MontserratNomde,MontserratNomde,,0,0,8,8,0,43,43,10,0.184913,0.229516,0
VulcanRita,VulcanRita,,0,22,0,22,129,0,129,0,0,0,0
AAixurach,AAixurach,,2,1,25,26,1,33,34,7,0.29393,0.371178,4366.665152
IgnasiPerez1,IgnasiPerez1,,2,0,5,5,0,9,9,10,0.169315,0.200486,0
RisaImma,RisaImma,,0,0,11,11,0,87,87,9,0.200288,0.254693,0
A_M_M_7_7,A_M_M_7_7,,7,0,17,17,0,21,21,9,0.235149,0.305407,0
ChalecosAmarill,ChalecosAmarill,,2,10,5,15,22,12,34,11,0.154875,0.178516,1070.22619
Estnom93,Estnom93,,0,19,8,27,84,60,144,10,0.184369,0.226724,1767.133333
Confraria_SEDR,Confraria_SEDR,,2,123,0,123,126,0,126,0,0,0,0
SOLARCATrepubli,SOLARCATrepubli,,0,2,14,16,2,32,34,10,0.197601,0.259236,109.507143
litomelani2014,litomelani2014,,2,0,7,7,0,8,8,10,0.17173,0.213564,0
francesc130,francesc130,,7,0,13,13,0,14,14,9,0.220205,0.276115,0
xavier_vives,xavier_vives,,6,4,11,15,8,16,24,9,0.24216,0.29813,280.671429
Bb7sus4,Bb7sus4,,2,0,6,6,0,8,8,8,0.229495,0.274815,0
mtdp08230,mtdp08230,,7,0,12,12,0,14,14,8,0.269641,0.325458,0
kataklock,kataklock,,1,6,1,7,6,1,7,1,1,1,5.6
ectaporta,ectaporta,,2,0,7,7,0,9,9,9,0.186202,0.221224,0
Giup7,Giup7,,3,0,9,9,0,9,9,8,0.24277,0.288525,0
MariaOxbow,MariaOxbow,,1,0,14,14,0,30,30,10,0.187036,0.240125,0
sedlr_,sedlr_,,2,121,1,122,156,4,160,0,0,0,0
dalmaucastanyer,dalmaucastanyer,,2,0,6,6,0,8,8,10,0.157925,0.182861,0
verdglauc,verdglauc,,1,0,5,5,0,5,5,9,0.2139,0.250105,0
noestanfacil65,noestanfacil65,,2,0,5,5,0,5,5,9,0.198713,0.230506,0
JoanRamonL,JoanRamonL,,1,10,25,35,12,60,72,10,0.209091,0.293595,8548.198947
Jordi7455,Jordi7455,,6,0,5,5,0,6,6,8,0.262808,0.301062,0
terra_pau,terra_pau,,6,0,5,5,0,6,6,13,0.121491,0.146905,0
xicabon,xicabon,,0,0,6,6,0,8,8,10,0.195241,0.243543,0
MinnesotaDe,MinnesotaDe,,3,36,0,36,60,0,60,0,0,0,0
Vinyaverda,Vinyaverda,,6,34,20,54,34,23,57,8,0.251595,0.331522,29075.27159
cfageda,cfageda,,6,0,6,6,0,9,9,12,0.138362,0.164908,0
TsunamiJordi,TsunamiJordi,,2,0,11,11,0,13,13,10,0.180456,0.224106,0
d_rusc,d_rusc,,1,4,2,6,7,2,9,9,0.218527,0.25915,1893.903789
AugeAdeu,AugeAdeu,,7,0,8,8,0,12,12,9,0.219493,0.26283,0
PuntiPere,PuntiPere,,7,15,12,27,16,17,33,10,0.199855,0.256885,4247.010304
Val_Roca_,Val_Roca_,,2,0,5,5,0,5,5,1,1,1,0
aracegea,aracegea,,7,2,12,14,2,16,18,9,0.215732,0.2658,51.942857
CasaReal,CasaReal,,1,6,0,6,16,0,16,0,0,0,0
RTRincha,RTRincha,,7,0,14,14,0,19,19,8,0.282828,0.342938,0
Corneli66092024,Corneli66092024,,2,0,8,8,0,12,12,10,0.170777,0.204586,0
pepegotera65,pepegotera65,,7,5,5,10,5,5,10,10,0.183687,0.22037,347.166667
Paulamartha7,Paulamartha7,,1,0,6,6,0,6,6,9,0.201601,0.234916,0
Montserratasta3,Montserratasta3,,2,0,10,10,0,14,14,10,0.186373,0.235721,0
CarmeRovira2408,CarmeRovira2408,,2,0,9,9,0,12,12,9,0.201888,0.243601,0
JosepCard10,JosepCard10,,2,4,4,8,6,5,11,12,0.14555,0.170187,125.166667
JoanRubioBarris,JoanRubioBarris,,2,0,7,7,0,7,7,9,0.204579,0.250996,0
xinluses,xinluses,,2,0,6,6,0,7,7,10,0.166466,0.194698,0
tonib1212,tonib1212,,7,0,13,13,0,15,15,8,0.263757,0.321116,0
gabrielrufian,gabrielrufian,,1,12,0,12,13,0,13,0,0,0,0
EmocionsxRep,EmocionsxRep,,7,0,13,13,0,20,20,13,0.124944,0.171814,0
acrata1789,acrata1789,,2,1,12,13,1,16,17,9,0.195606,0.245554,4634.79779
i_Cat_Lliure,i_Cat_Lliure,,1,7,1,8,9,3,12,0,0,0,0
Manu_K_tala,Manu_K_tala,,6,0,23,23,0,26,26,7,0.319588,0.394752,0
liguana4,liguana4,,3,0,7,7,0,7,7,10,0.202772,0.248802,0
LluisMaBassas,LluisMaBassas,,2,0,8,8,0,10,10,9,0.195346,0.231275,0
josep_gros,josep_gros,,2,0,11,11,0,11,11,8,0.231219,0.277854,0
Immamorro,Immamorro,,2,0,10,10,0,10,10,10,0.178161,0.218628,0
MesGrillat,MesGrillat,,2,1,5,6,1,6,7,11,0.16264,0.191324,90.700902
RosaEscardo,RosaEscardo,,4,0,12,12,0,23,23,8,0.247101,0.304904,0
Mireiavam,Mireiavam,,6,0,8,8,0,9,9,9,0.210008,0.249577,0
2208mellado,2208mellado,,6,0,5,5,0,6,6,12,0.140681,0.170097,0
Cacadelux,Cacadelux,,7,0,10,10,0,16,16,8,0.253431,0.299725,0
Erramun2014,Erramun2014,,2,137,1,138,170,1,171,0,0,0,0
LlogamCadaques,LlogamCadaques,,6,1,12,13,1,13,14,9,0.205357,0.255912,3306.956487
ecrispi,ecrispi,,1,1,6,7,1,8,9,10,0.178364,0.214132,96.392857
LVinyes,LVinyes,,7,0,5,5,0,7,7,3,0.666667,0.791667,0
Zacur22,Zacur22,,3,0,6,6,0,6,6,10,0.188179,0.221722,0
minerve81,minerve81,,7,0,8,8,0,8,8,9,0.216216,0.272243,0
galarufus,galarufus,,3,3,6,9,3,7,10,9,0.193684,0.227053,10279.202484
ReallySedicious,ReallySedicious,,3,0,5,5,0,5,5,10,0.172157,0.202156,0
slipnegre,slipnegre,,6,1,4,5,1,4,5,9,0.216132,0.250894,633.16666
LesAntonies,LesAntonies,,2,0,7,7,0,8,8,3,0.590909,0.730769,0
CDotze,CDotze,,6,16,6,22,16,7,23,8,0.231156,0.26712,12364.505437
miriamnoguerasM,miriamnoguerasM,,6,10,2,12,10,2,12,2,0.666667,0.75,98.983045
EnricBCNcat,EnricBCNcat,,4,26,9,35,37,11,48,9,0.246649,0.299053,36395.273294
Raquel_Laia,Raquel_Laia,,2,0,14,14,0,16,16,9,0.212214,0.274288,0
joanarinoibarz,joanarinoibarz,,1,29,8,37,38,12,50,2,0.9,0.944444,654.925505
Wittgenstein_jm,Wittgenstein_jm,,7,0,25,25,0,39,39,8,0.265345,0.347017,0
Foreign_Cat,Foreign_Cat,,3,38,6,44,39,9,48,9,0.205357,0.24391,7626.419283
Pep95527177,Pep95527177,,6,0,10,10,0,10,10,10,0.207589,0.255789,0
ramonsalvia,ramonsalvia,,7,2,9,11,2,9,11,9,0.198418,0.246988,5405.343381
MariaBrichs,MariaBrichs,,7,0,8,8,0,12,12,11,0.176997,0.22543,0
jasaezbenito,jasaezbenito,,1,3,22,25,3,22,25,7,0.290221,0.362905,1897.216241
UlissesXX,UlissesXX,,1,4,5,9,4,5,9,10,0.196441,0.232892,1920.233369
SaxCrooner,SaxCrooner,,2,0,7,7,0,10,10,9,0.214562,0.254798,0
matius_71,matius_71,,6,1,8,9,1,9,10,2,0.9,0.944444,5
mirovira75,mirovira75,,3,0,10,10,0,13,13,11,0.175063,0.226035,0
COSTAMARTA10,COSTAMARTA10,,3,0,7,7,0,8,8,9,0.218799,0.258077,0
Marisa49088594,Marisa49088594,,2,0,10,10,0,12,12,11,0.166867,0.208191,0
peppujool,peppujool,,2,0,9,9,0,10,10,10,0.177564,0.217367,0
Krstna12,Krstna12,,6,0,6,6,0,7,7,9,0.201748,0.237681,0
denterd,denterd,,6,28,0,28,30,0,30,0,0,0,0
paredesrosf,paredesrosf,,2,0,6,6,0,6,6,11,0.170109,0.213151,0
nisalsrre,nisalsrre,,2,0,5,5,0,7,7,1,1,1,0
CVinardell,CVinardell,,6,0,5,5,0,6,6,9,0.183322,0.218085,0
saberuts,saberuts,,2,0,23,23,0,30,30,9,0.240964,0.317459,0
Martipe9,Martipe9,,6,0,5,5,0,5,5,10,0.185013,0.221114,0
JArquero7,JArquero7,,1,0,8,8,0,9,9,9,0.190184,0.235016,0
Eulalia_Serra_,Eulalia_Serra_,,4,0,5,5,0,7,7,8,0.256244,0.297426,0
anna_arque,anna_arque,,4,49,2,51,59,2,61,8,0.225306,0.257803,34983.16198
aster2013,aster2013,,2,0,6,6,0,7,7,10,0.175472,0.21841,0
somhirepublica,somhirepublica,,6,0,7,7,0,9,9,9,0.208742,0.246043,0
i_lora61,i_lora61,,2,0,18,18,0,22,22,9,0.235945,0.304411,0
JManimar,JManimar,,2,73,1,74,83,1,84,9,0.184369,0.202413,18588.038146
dserram,dserram,,1,3,4,7,3,4,7,3,0.6,0.703704,1028.721825
GillStella,GillStella,,4,5,7,12,5,10,15,8,0.234694,0.278313,4017.925887
VilaWeb,VilaWeb,,4,9,0,9,10,0,10,0,0,0,0
turbodeif,turbodeif,,1,2,3,5,2,3,5,10,0.179172,0.20497,9.425
GlobalSpain,GlobalSpain,,1,10,0,10,21,0,21,0,0,0,0
FanaletFernando,FanaletFernando,,7,2,15,17,2,17,19,9,0.23505,0.291535,30.25
mariahelena57b1,mariahelena57b1,,6,0,12,12,0,14,14,9,0.237386,0.300263,0
roger_bach,roger_bach,,1,5,17,22,5,22,27,9,0.23204,0.296575,481.645238
Ewidal,Ewidal,,6,1,7,8,1,18,19,12,0.151648,0.194866,70.361111
Ry4ofuaq1FbeNYQ,Ry4ofuaq1FbeNYQ,,7,0,7,7,0,9,9,9,0.218972,0.258378,0
rosamirob,rosamirob,,6,1,14,15,1,17,18,9,0.221609,0.288937,47.384524
asenye,asenye,,4,0,5,5,0,6,6,10,0.179404,0.211194,0
jaumesol,jaumesol,,4,0,6,6,0,7,7,10,0.166566,0.20293,0
Egarcamp111,Egarcamp111,,2,0,34,34,0,48,48,9,0.263208,0.36717,0
MARIBELGMEZHUE1,MARIBELGMEZHUE1,,7,0,11,11,0,15,15,10,0.209023,0.261909,0
josepbastardas,josepbastardas,,4,0,13,13,0,16,16,8,0.227941,0.283355,0
Shailita,Shailita,,3,0,5,5,0,5,5,10,0.185457,0.216081,0
ANC_Bombers,ANC_Bombers,,6,27,1,28,28,1,29,0,0,0,0
free_yellow1,free_yellow1,,4,1,6,7,1,8,9,9,0.224473,0.267253,27.669048
antoniobanos_,antoniobanos_,,1,11,0,11,12,0,12,0,0,0,0
marta0092,marta0092,,6,0,5,5,0,5,5,10,0.158467,0.182586,0
Sempre52,Sempre52,,1,0,5,5,0,5,5,1,1,1,0
PacoMontezemolo,PacoMontezemolo,,2,39,1,40,45,3,48,0,0,0,0
jfigue33,jfigue33,,7,0,7,7,0,11,11,9,0.200145,0.238382,0
andreubarnils,andreubarnils,,7,7,0,7,7,0,7,0,0,0,0
4_ferran,4_ferran,,5,6,6,12,41,25,66,11,0.139418,0.163018,303.583333
nuriallibertatc,nuriallibertatc,,3,0,20,20,0,23,23,8,0.274779,0.349094,0
montsepob,montsepob,,6,0,10,10,0,12,12,8,0.264313,0.315682,0
angelsclotet,angelsclotet,,6,0,5,5,0,5,5,9,0.21275,0.248239,0
mariadenines4,mariadenines4,,2,0,17,17,0,24,24,9,0.235889,0.298474,0
Ninona62,Ninona62,,2,5,10,15,6,11,17,10,0.192872,0.238143,2110.050397
NuriaJomba12,NuriaJomba12,,4,2,13,15,2,22,24,8,0.256983,0.318263,4856.489583
Jepcdr,Jepcdr,,2,0,7,7,0,8,8,9,0.203079,0.23993,0
MG39076207,MG39076207,,6,0,6,6,0,6,6,9,0.218652,0.260326,0
ESensenom,ESensenom,,6,4,7,11,4,7,11,10,0.195637,0.243077,198.458117
btvnoticies,btvnoticies,,7,6,1,7,6,1,7,0,0,0,0
CrisidelsCrisis,CrisidelsCrisis,,3,48,7,55,59,12,71,9,0.225859,0.267006,19865.900276
roserbb1,roserbb1,,7,0,11,11,0,21,21,13,0.13742,0.188164,0
Euginy__Esfort,Euginy__Esfort,,2,0,7,7,0,9,9,11,0.154232,0.184297,0
vgutiez,vgutiez,,1,3,2,5,3,2,5,1,1,1,4.333333
CatFree18,CatFree18,,2,0,5,5,0,5,5,10,0.187838,0.225241,0
DarthVaderBcn,DarthVaderBcn,,4,0,13,13,0,15,15,8,0.262512,0.331984,0
Frisac,Frisac,,2,0,16,16,0,17,17,10,0.180064,0.240911,0
adic_int,adic_int,,1,22,3,25,33,5,38,12,0.122885,0.140249,10852.686111
lacasaingalls,lacasaingalls,,6,0,7,7,0,20,20,12,0.138362,0.177315,0
MariaRosaTorras,MariaRosaTorras,,6,0,6,6,0,6,6,11,0.158224,0.191934,0
Klinkmi,Klinkmi,,3,27,7,34,27,9,36,10,0.1875,0.222897,3678.607227
miripifer,miripifer,,4,0,6,6,0,9,9,9,0.212586,0.249744,0
rolandjauclas,rolandjauclas,,1,0,14,14,0,15,15,9,0.248654,0.316032,0
ivaxsirc,ivaxsirc,,0,1,5,6,1,7,8,8,0.230641,0.271093,273
ErnestoEkaizer,ErnestoEkaizer,,1,8,0,8,9,0,9,0,0,0,0
TOMASHROLDAN,TOMASHROLDAN,,1,6,13,19,22,51,73,10,0.197284,0.247966,16750.562401
Dolors63,Dolors63,,6,1,8,9,1,8,9,9,0.190345,0.226684,955.738297
Cesc73096516,Cesc73096516,,2,0,20,20,0,32,32,8,0.258813,0.325461,0
anaoromilluch,anaoromilluch,,2,0,11,11,0,15,15,8,0.244522,0.301148,0
vilacosc,vilacosc,,6,0,12,12,0,16,16,9,0.260583,0.31843,0
ArinOrtiz,ArinOrtiz,,7,0,9,9,0,13,13,9,0.213735,0.257144,0
SergiRi7,SergiRi7,,0,0,16,16,0,35,35,8,0.252717,0.315429,0
Verdum15,Verdum15,,0,5,7,12,5,38,43,10,0.184544,0.226808,40.366006
nuarimany,nuarimany,,4,0,6,6,0,7,7,8,0.24735,0.295157,0
farithyme,farithyme,,3,1,5,6,1,5,6,9,0.206691,0.242515,51.766667
miqueliceta,miqueliceta,,1,7,0,7,15,0,15,0,0,0,0
jara_toni,jara_toni,,2,0,5,5,0,5,5,9,0.211774,0.246133,0
EstiradoLeonor,EstiradoLeonor,,2,0,11,11,0,20,20,11,0.166866,0.209964,0
RocaMarsroca,RocaMarsroca,,0,0,7,7,0,19,19,10,0.184544,0.226808,0
baphomed75,baphomed75,,4,42,2,44,53,2,55,9,0.211819,0.244528,9233.568692
nobape,nobape,,4,1,4,5,1,4,5,9,0.222043,0.260082,458.933333
bel_margarida,bel_margarida,,0,0,6,6,0,13,13,10,0.184421,0.225003,0
rtbcrm,rtbcrm,,2,0,8,8,0,9,9,11,0.150027,0.191964,0
ElisaCa61,ElisaCa61,,4,0,5,5,0,5,5,9,0.204412,0.242562,0
Nane_nanemusic,Nane_nanemusic,,7,0,6,6,0,7,7,11,0.154616,0.188824,0
llopratsara,llopratsara,,7,26,1,27,36,1,37,9,0.184246,0.202231,2645.975289
M_BrokenLeg,M_BrokenLeg,,6,1,14,15,1,16,17,8,0.237931,0.301178,3242.282298
CristinaEFlor1,CristinaEFlor1,,6,1,7,8,2,10,12,9,0.210606,0.24823,0
yayabombera,yayabombera,,7,0,10,10,0,15,15,2,0.777778,0.857143,0
lunadelsur2012,lunadelsur2012,,1,0,5,5,0,6,6,10,0.19244,0.232854,0
gemmadDesign,gemmadDesign,,1,1,8,9,1,8,9,9,0.204428,0.24604,149.440476
miro_merce,miro_merce,,2,0,5,5,0,5,5,12,0.127581,0.162119,0
Nex72599860,Nex72599860,,4,1,4,5,1,4,5,9,0.212799,0.246965,884.658045
iraventos,iraventos,,1,4,4,8,4,4,8,1,1,1,766.091941
QuimTorraiPla,QuimTorraiPla,,4,8,0,8,11,0,11,0,0,0,0
badalola58,badalola58,,0,0,11,11,0,12,12,9,0.24,0.296604,0
jcoscu,jcoscu,,1,7,0,7,10,0,10,0,0,0,0
Involuci1,Involuci1,,6,0,5,5,0,7,7,13,0.121545,0.146945,0
pardodevera,pardodevera,,3,8,0,8,8,0,8,0,0,0,0
SCalull,SCalull,,7,0,5,5,0,10,10,1,1,1,0
JosepLluis2001,JosepLluis2001,,1,0,13,13,0,18,18,9,0.21821,0.279259,0
NiNetaAltraCop,NiNetaAltraCop,,4,18,5,23,18,10,28,8,0.229808,0.270536,4576.579017
matildedescals,matildedescals,,1,0,5,5,0,7,7,10,0.185333,0.229536,0
ebudo6566,ebudo6566,,2,5,0,5,5,0,5,0,0,0,0
PereLleixa,PereLleixa,,1,21,18,39,22,21,43,9,0.195329,0.254837,9359.182877
ConxitaBou,ConxitaBou,,6,0,9,9,0,10,10,7,0.254362,0.306713,0
focaiguaiterra,focaiguaiterra,,1,2,10,12,2,11,13,9,0.239206,0.293615,251.616667
Guatlleta,Guatlleta,,6,0,7,7,0,8,8,9,0.204562,0.252555,0
isidrecp,isidrecp,,6,0,13,13,0,19,19,8,0.24369,0.303193,0
albertperico,albertperico,,6,0,7,7,0,7,7,13,0.120922,0.156154,0
TuraTF,TuraTF,,1,0,9,9,0,12,12,9,0.184434,0.227844,0
les_pedretes,les_pedretes,,2,0,6,6,0,7,7,9,0.204978,0.237769,0
cota3143,cota3143,,4,0,13,13,0,17,17,8,0.249332,0.311229,0
danielsalvado,danielsalvado,,2,8,0,8,8,0,8,0,0,0,0
LuciaVidaldePu1,LuciaVidaldePu1,,2,0,9,9,0,9,9,2,0.621622,0.695652,0
Vilacm2,Vilacm2,,7,1,7,8,1,11,12,8,0.206408,0.243201,67.1
aleixsarri,aleixsarri,,6,6,1,7,7,2,9,1,1,1,2.233333
llunavermella,llunavermella,,7,0,7,7,0,10,10,10,0.167168,0.197745,0
XSalaimartin,XSalaimartin,,1,13,0,13,13,0,13,0,0,0,0
dolcanina,dolcanina,,4,0,8,8,0,9,9,8,0.217799,0.259319,0
LibertoPalauSer,LibertoPalauSer,,2,1,12,13,1,14,15,8,0.238258,0.298033,244.02381
MLiceranNieto,MLiceranNieto,,2,0,5,5,0,5,5,13,0.122242,0.150501,0
las3eses1,las3eses1,,2,0,8,8,0,13,13,10,0.191856,0.244761,0
peronelladarago,peronelladarago,,4,4,2,6,4,2,6,9,0.209886,0.237061,352.293146
LuisJos57675062,LuisJos57675062,,2,0,24,24,0,34,34,8,0.294615,0.374599,0
xavidomenech99,xavidomenech99,,3,3,3,6,3,3,6,10,0.192603,0.223738,5136.129935
lluis_llach,lluis_llach,,7,2,3,5,2,5,7,1,1,1,120.675
dvdjl73,dvdjl73,,1,0,9,9,0,21,21,11,0.154875,0.188989,0
margaritafontr,margaritafontr,,6,0,8,8,0,9,9,13,0.125567,0.165469,0
ShaAcabat,ShaAcabat,,7,6,0,6,7,0,7,0,0,0,0
yakimalalimpia,yakimalalimpia,,2,1,5,6,1,5,6,1,1,1,0
PilarHLuc,PilarHLuc,,2,49,1,50,63,6,69,0,0,0,0
Virgili7,Virgili7,,1,3,6,9,3,6,9,10,0.185111,0.228507,17452.356132
Nuria363,Nuria363,,2,0,5,5,0,5,5,11,0.163037,0.192179,0
lolalailo,lolalailo,,1,0,12,12,0,14,14,9,0.233691,0.293767,0
CatalanetE,CatalanetE,,1,4,10,14,5,10,15,11,0.143744,0.182884,131.933333
caputxetadepics,caputxetadepics,,2,0,7,7,0,9,9,10,0.188132,0.224144,0
Guialcoaching,Guialcoaching,,1,5,15,20,5,15,20,10,0.180984,0.233185,2895.816964
LarssonMontse,LarssonMontse,,6,0,14,14,0,14,14,9,0.211612,0.267165,0
RTapiasCors,RTapiasCors,,6,0,6,6,0,7,7,9,0.2159,0.254523,0
rcpuig94,rcpuig94,,6,2,6,8,2,9,11,2,0.875,0.928571,12.25
abague60,abague60,,6,0,9,9,0,9,9,14,0.11472,0.156268,0
VilaViladrosa,VilaViladrosa,,6,0,6,6,0,7,7,10,0.194425,0.232988,0
josepm_giner,josepm_giner,,2,0,7,7,0,8,8,9,0.211684,0.250014,0
either_mark,either_mark,,4,3,5,8,3,8,11,9,0.215794,0.254539,1397.727273
Pepsina_Mataro,Pepsina_Mataro,,6,21,0,21,21,0,21,0,0,0,0
ESTRELA_ROJA,ESTRELA_ROJA,,5,2,4,6,3,21,24,11,0.139279,0.15942,2.25
Juanmi_News,Juanmi_News,,1,7,1,8,7,1,8,0,0,0,0
premianencs,premianencs,,7,0,8,8,0,10,10,9,0.204545,0.255428,0
BeatrizTalegon,BeatrizTalegon,,1,6,0,6,6,0,6,0,0,0,0
Otger68,Otger68,,2,0,8,8,0,9,9,9,0.215397,0.257682,0
Seny_i_rauxa,Seny_i_rauxa,,2,0,9,9,0,9,9,10,0.187332,0.240869,0
cava_SEdR,cava_SEdR,,3,0,6,6,0,7,7,10,0.199286,0.239129,0
jromeug,jromeug,,1,2,6,8,2,7,9,3,0.571429,0.708333,14.480952
ArenosPepa,ArenosPepa,,7,0,8,8,0,15,15,2,0.642857,0.722222,0
EmDicMerce,EmDicMerce,,1,0,13,13,0,14,14,7,0.267925,0.325956,0
TRoderic,TRoderic,,2,9,2,11,10,3,13,1,1,1,7
MsSamsoroca,MsSamsoroca,,2,0,8,8,0,13,13,10,0.174433,0.212272,0
MERMI69,MERMI69,,2,0,7,7,0,10,10,13,0.124271,0.159399,0
dracdolot,dracdolot,,2,41,0,41,41,0,41,0,0,0,0
EmmaGon2,EmmaGon2,,4,0,6,6,0,6,6,12,0.14006,0.169711,0
NoEsPotCat,NoEsPotCat,,2,25,0,25,29,0,29,0,0,0,0
Cjaumev,Cjaumev,,3,0,9,9,0,9,9,9,0.21555,0.264396,0
CxRSabadell,CxRSabadell,,3,12,1,13,12,1,13,0,0,0,0
ramonone55,ramonone55,,2,0,14,14,0,23,23,9,0.21517,0.273705,0
trapella1714,trapella1714,,7,7,2,9,7,2,9,10,0.160652,0.178947,101.144481
marichmoda2,marichmoda2,,2,0,6,6,0,6,6,9,0.184421,0.219038,0
solaagnes,solaagnes,,7,0,9,9,0,11,11,15,0.092691,0.124353,0
Laksmizz,Laksmizz,,4,7,1,8,7,2,9,10,0.160186,0.175746,272.416667
DewCatalunya,DewCatalunya,,3,2,4,6,2,4,6,15,0.091958,0.107816,0
comuni_cats,comuni_cats,,3,14,1,15,14,1,15,1,1,1,95.578571
Eratolyre,Eratolyre,,2,73,1,74,73,1,74,1,1,1,124.916667
AngieCa94256510,AngieCa94256510,,2,24,1,25,24,1,25,0,0,0,0
Anna77548272,Anna77548272,,2,0,6,6,0,8,8,15,0.091661,0.114644,0
Carme86154050,Carme86154050,,4,0,6,6,0,9,9,8,0.21811,0.252725,0
Araselicg,Araselicg,,2,0,5,5,0,5,5,9,0.205621,0.249586,0
MelindaCatalan,MelindaCatalan,,2,0,8,8,0,8,8,11,0.156459,0.191891,0
oscarsemtts,oscarsemtts,,1,0,7,7,0,7,7,10,0.166767,0.203041,0
RSUAREZ4,RSUAREZ4,,4,53,3,56,68,3,71,9,0.190476,0.216992,3591.707606
Alberto97246103,Alberto97246103,,2,0,11,11,0,12,12,10,0.176997,0.225446,0
kmaleonmanel,kmaleonmanel,,2,0,7,7,0,8,8,10,0.174984,0.211362,0
La_Palo_62,La_Palo_62,,2,7,2,9,8,2,10,1,1,1,16.583333
FlotatM,FlotatM,,2,0,13,13,0,15,15,9,0.239243,0.292109,0
manelrainers,manelrainers,,1,0,8,8,0,11,11,9,0.201601,0.241773,0
Estellencs1,Estellencs1,,2,0,9,9,0,11,11,9,0.186031,0.225652,0
Celiaizq,Celiaizq,,6,0,5,5,0,6,6,2,0.857143,0.916667,0
freed4Catalonia,freed4Catalonia,,2,0,5,5,0,9,9,1,1,1,0
CROcultura1,CROcultura1,,4,6,10,16,8,18,26,8,0.268744,0.326863,20735.895414
JoseMar72168618,JoseMar72168618,,4,1,19,20,1,27,28,8,0.251366,0.3245,5691.888755
338iol,338iol,,2,0,12,12,0,14,14,9,0.204713,0.253125,0
lulu6019,lulu6019,,7,0,15,15,0,20,20,8,0.247569,0.305672,0
txellblanxer,txellblanxer,,2,0,9,9,0,9,9,10,0.173777,0.218149,0
ABalagu,ABalagu,,4,97,5,102,129,8,137,8,0.246209,0.293129,40613.203635
llubaps,llubaps,,2,78,3,81,79,4,83,10,0.17795,0.199976,6259.399384
sotoarmengol,sotoarmengol,,2,3,6,9,11,14,25,10,0.165378,0.191113,197.432359
f2008friends,f2008friends,,4,0,9,9,0,11,11,9,0.217085,0.265465,0
ConnorJHO,ConnorJHO,,7,9,0,9,9,0,9,0,0,0,0
franksierrafoto,franksierrafoto,,1,0,5,5,0,7,7,13,0.121705,0.148144,0
Llunas3,Llunas3,,7,0,10,10,0,27,27,10,0.191431,0.236988,0
Reagrupament,Reagrupament,,6,12,0,12,14,0,14,0,0,0,0
edp,edp,,2,3,2,5,3,4,7,2,0.625,0.7,818.5
vctor92305336,vctor92305336,,2,0,7,7,0,10,10,9,0.186954,0.219242,0
cbonaventura,cbonaventura,,6,1,10,11,1,13,14,10,0.170581,0.209761,2419.248016
jaumetrullas,jaumetrullas,,6,0,6,6,0,6,6,9,0.188692,0.222825,0
Roger_Lluriach,Roger_Lluriach,,2,0,7,7,0,12,12,10,0.187797,0.226274,0
Ssuricat,Ssuricat,,3,0,7,7,0,8,8,9,0.210287,0.253631,0
JPeiroV,JPeiroV,,1,7,11,18,9,11,20,9,0.206326,0.251744,597.105952
mcote16,mcote16,,7,0,5,5,0,7,7,9,0.191298,0.225027,0
Lena41384087,Lena41384087,,1,0,7,7,0,9,9,1,1,1,0
marjose_bcn,marjose_bcn,,2,0,6,6,0,6,6,11,0.155182,0.188921,0
nyecnyec,nyecnyec,,2,8,12,20,12,17,29,10,0.175908,0.221607,2635.127345
Opticaroures,Opticaroures,,2,0,6,6,0,8,8,3,0.578947,0.727273,0
Josepm48579968,Josepm48579968,,7,0,5,5,0,8,8,12,0.13276,0.162142,0
thecatalancbf,thecatalancbf,,2,5,0,5,5,0,5,0,0,0,0
byebyeEsp,byebyeEsp,,3,0,6,6,0,6,6,9,0.206871,0.245496,0
MAxiuxiueig,MAxiuxiueig,,6,0,5,5,0,6,6,8,0.23096,0.27069,0
jmpelleja,jmpelleja,,2,0,11,11,0,12,12,8,0.237489,0.284486,0
filog3,filog3,,2,0,14,14,0,18,18,8,0.267308,0.3219,0
Neus76324905,Neus76324905,,6,0,7,7,0,7,7,10,0.181046,0.216824,0
puigamer,puigamer,,4,0,5,5,0,5,5,9,0.206999,0.246694,0
11joan2,11joan2,,7,1,10,11,1,14,15,10,0.166469,0.205091,276
Montsinova2,Montsinova2,,2,15,2,17,21,2,23,11,0.161877,0.185781,2333.465873
msaltorviver,msaltorviver,,6,0,5,5,0,5,5,9,0.2,0.232868,0
nuriamcat,nuriamcat,,0,17,6,23,43,19,62,10,0.183877,0.222195,74.49934
varoufakis3,varoufakis3,,4,45,0,45,65,0,65,0,0,0,0
en_neg,en_neg,,2,0,6,6,0,6,6,9,0.231219,0.283459,0
oscarpla_57,oscarpla_57,,2,37,0,37,41,0,41,0,0,0,0
gallifantes,gallifantes,,1,10,0,10,11,0,11,0,0,0,0
cervera_jess,cervera_jess,,7,1,6,7,2,6,8,9,0.20473,0.23977,29.45
ccorti80,ccorti80,,1,2,4,6,2,4,6,9,0.230384,0.262877,153.683045
An77Ver,An77Ver,,7,0,19,19,0,23,23,7,0.290155,0.358537,0
Marcel07581100,Marcel07581100,,6,0,12,12,0,14,14,9,0.209531,0.262432,0
jjvidal1,jjvidal1,,1,30,7,37,33,7,40,10,0.179571,0.218322,7595.404624
AnaFern52249672,AnaFern52249672,,6,0,6,6,0,9,9,2,0.8,0.875,0
Tcom_g,Tcom_g,,1,0,7,7,0,7,7,8,0.226122,0.265897,0
Liz_beth_GB,Liz_beth_GB,,1,2,7,9,2,10,12,9,0.203527,0.250158,382.815873
CatalanWay_,CatalanWay_,,3,1,5,6,1,6,7,9,0.200722,0.240737,76.446429
Carolin92756159,Carolin92756159,,7,0,7,7,0,9,9,10,0.176658,0.207795,0
Dumacbcn,Dumacbcn,,2,93,0,93,96,0,96,0,0,0,0
merybrunet,merybrunet,,6,0,8,8,0,8,8,10,0.181401,0.218989,0
abtrba,abtrba,,4,0,5,5,0,5,5,9,0.215062,0.251725,0
hrincu67,hrincu67,,2,0,7,7,0,7,7,10,0.169005,0.203538,0
sanchezcastejon,sanchezcastejon,,1,17,0,17,17,0,17,0,0,0,0
pitagoras1545,pitagoras1545,,6,0,9,9,0,10,10,9,0.237447,0.282332,0
VicRF72,VicRF72,,1,11,3,14,12,5,17,11,0.159078,0.183786,1764.140801
psicoetyam,psicoetyam,,4,0,8,8,0,9,9,8,0.240034,0.286459,0
Pol_i_Roc,Pol_i_Roc,,6,32,13,45,32,16,48,8,0.282497,0.336952,23177.562309
saralidiaester,saralidiaester,,6,2,5,7,2,6,8,9,0.209408,0.246167,1148.394444
jmgarcia13,jmgarcia13,,6,2,3,5,2,3,5,1,1,1,3.75
ceciliaencina,ceciliaencina,,6,4,9,13,5,11,16,9,0.236797,0.27975,289.880952
Gustaff69,Gustaff69,,1,6,8,14,6,9,15,1,1,1,34.811905
castel_liv,castel_liv,,0,7,1,8,8,1,9,1,1,1,5.166667
RaiLopezCalvet,RaiLopezCalvet,,1,5,0,5,5,0,5,0,0,0,0
Beatriu20,Beatriu20,,2,0,5,5,0,5,5,1,1,1,0
piopio95027380,piopio95027380,,1,0,5,5,0,9,9,10,0.191197,0.23751,0
RMarsinyach,RMarsinyach,,6,0,5,5,0,5,5,9,0.21319,0.248446,0
LaSelenita,LaSelenita,,7,3,8,11,3,9,12,9,0.183809,0.214877,30.242857
GarritMagda,GarritMagda,,7,0,7,7,0,8,8,2,0.769231,0.85,0
RebeketaPelFred,RebeketaPelFred,,6,0,19,19,0,21,21,9,0.245004,0.328908,0
MonalisaDeLego,MonalisaDeLego,,4,0,8,8,0,10,10,11,0.177977,0.231021,0
GermanDeJuana,GermanDeJuana,,1,3,2,5,4,3,7,11,0.144112,0.158577,4.75
kepapere,kepapere,,1,2,5,7,2,5,7,10,0.168275,0.194498,286.75
Laia1961,Laia1961,,6,0,8,8,0,9,9,10,0.172909,0.208835,0
ras_curt,ras_curt,,7,0,10,10,0,11,11,9,0.224374,0.282548,0
Elsa_Punky,Elsa_Punky,,1,0,12,12,0,12,12,8,0.255223,0.32053,0
ASHZEN17,ASHZEN17,,3,1,19,20,1,26,27,8,0.268786,0.334387,0
GemmaVerdos,GemmaVerdos,,4,0,5,5,0,5,5,9,0.213241,0.251708,0
sinceridad75,sinceridad75,,1,3,2,5,3,2,5,9,0.198566,0.224143,633.342857
joanmariapique,joanmariapique,,6,10,7,17,10,8,18,10,0.171322,0.208261,12864.010044
caigueral2,caigueral2,,5,7,2,9,12,2,14,10,0.158986,0.177903,11679.232937
BenitezNeus,BenitezNeus,,2,0,9,9,0,11,11,10,0.171711,0.211347,0
freeredndwild,freeredndwild,,6,0,8,8,0,9,9,10,0.181639,0.222353,0
gregorioperezag,gregorioperezag,,6,0,10,10,0,11,11,10,0.18152,0.225113,0
benoitmortier1,benoitmortier1,,6,0,5,5,0,6,6,10,0.186577,0.217276,0
AssembSmallorcA,AssembSmallorcA,,6,5,0,5,5,0,5,0,0,0,0
Quim6749,Quim6749,,7,0,6,6,0,6,6,8,0.22506,0.266966,0
MmNovau,MmNovau,,6,6,3,9,6,3,9,10,0.16409,0.195498,1607.700512
thomasj76083568,thomasj76083568,,2,0,5,5,0,5,5,8,0.225832,0.25944,0
hannahbcn1,hannahbcn1,,4,5,20,25,5,20,25,8,0.274081,0.351178,7404.903958
M_Carme4667RiTA,M_Carme4667RiTA,,0,5,6,11,5,17,22,10,0.184369,0.225516,63.568687
MerigoMagrina,MerigoMagrina,,7,0,5,5,0,8,8,13,0.121865,0.148309,0
Esquitx17,Esquitx17,,4,1,15,16,1,28,29,8,0.277946,0.346135,9832.764902
EtsBorg,EtsBorg,,4,17,6,23,21,8,29,9,0.22716,0.267017,3823.620368
mariatubi,mariatubi,,2,0,5,5,0,5,5,15,0.091722,0.112926,0
ipanemals,ipanemals,,7,0,5,5,0,5,5,12,0.139742,0.171155,0
ValentinaLeni,ValentinaLeni,,7,0,13,13,0,17,17,9,0.218652,0.273602,0
Fredi66156814,Fredi66156814,,7,3,2,5,3,2,5,11,0.159838,0.181632,334.116667
MRRCCM,MRRCCM,,1,0,5,5,0,6,6,10,0.163037,0.189819,0
VallmajorJoan,VallmajorJoan,,6,0,8,8,0,11,11,13,0.120174,0.158785,0
ZanuyMunn,ZanuyMunn,,4,20,5,25,20,6,26,8,0.242531,0.276445,13429.124301
LastraColsa,LastraColsa,,6,0,6,6,0,7,7,9,0.210167,0.247758,0
perecortes48,perecortes48,,2,0,5,5,0,5,5,10,0.161722,0.187958,0
p_pmorales,p_pmorales,,2,0,6,6,0,6,6,9,0.214065,0.249576,0
cayetanaAT,cayetanaAT,,1,6,0,6,6,0,6,0,0,0,0
marti_benet,marti_benet,,0,0,12,12,0,58,58,9,0.222484,0.27713,0
PalabrasdePepe,PalabrasdePepe,,2,32,1,33,48,7,55,0,0,0,0
lloverpez,lloverpez,,2,0,7,7,0,7,7,10,0.15883,0.188456,0
dracs1714,dracs1714,,7,0,6,6,0,8,8,10,0.188179,0.222142,0
EspanaGlobal,EspanaGlobal,,1,8,0,8,17,0,17,0,0,0,0
miquelflorit,miquelflorit,,7,0,6,6,0,8,8,3,0.666667,0.783333,0
JGodall,JGodall,,2,0,5,5,0,5,5,10,0.176321,0.21326,0
tramptramptramp,tramptramptramp,,2,0,5,5,0,5,5,9,0.224013,0.265319,0
NbT59,NbT59,,1,0,5,5,0,8,8,10,0.18152,0.222198,0
1denmadrid,1denmadrid,,2,0,10,10,0,16,16,9,0.225989,0.285425,0
putopitillos2,putopitillos2,,1,1,7,8,1,8,9,10,0.185532,0.223244,7.809524
JaumePinyol2,JaumePinyol2,,2,0,11,11,0,19,19,8,0.2415,0.291551,0
pjcherto,pjcherto,,7,0,8,8,0,9,9,15,0.092642,0.121521,0
RosaPulido6,RosaPulido6,,2,0,5,5,0,5,5,13,0.122458,0.150967,0
CalPepi,CalPepi,,7,0,16,16,0,22,22,9,0.216551,0.274623,0
RamonSole5,RamonSole5,,0,4,1,5,4,1,5,1,1,1,11
EuroscepticBCN,EuroscepticBCN,,1,4,1,5,5,1,6,1,1,1,151.607764
Drehgestell,Drehgestell,,2,0,9,9,0,10,10,9,0.20718,0.25199,0
Cat72222,Cat72222,,2,10,1,11,10,1,11,10,0.178594,0.200338,732.539683
calix_cicero,calix_cicero,,6,0,6,6,0,7,7,13,0.132854,0.167101,0
Algonfdez,Algonfdez,,1,0,5,5,0,5,5,2,0.777778,0.857143,0
evaguillenhida1,evaguillenhida1,,2,0,5,5,0,6,6,13,0.121865,0.148309,0
XavierMolero,XavierMolero,,2,0,5,5,0,5,5,9,0.200145,0.233469,0
Jaume752,Jaume752,,6,2,7,9,2,7,9,9,0.211111,0.25594,282.441667
economiacat1,economiacat1,,6,16,5,21,19,6,25,9,0.211982,0.244183,3145.747785
santcodto,santcodto,,1,0,5,5,0,5,5,9,0.190281,0.220341,0
VINTISET,VINTISET,,1,0,14,14,0,14,14,9,0.26949,0.331056,0
AmatGemma,AmatGemma,,2,3,2,5,3,2,5,2,0.625,0.7,9
gemquim,gemquim,,4,3,8,11,3,13,16,8,0.250227,0.298572,1520.794589
assumptalba,assumptalba,,7,0,5,5,0,7,7,11,0.161422,0.190829,0
neus533,neus533,,2,0,15,15,0,16,16,8,0.261074,0.318283,0
tonicesteve,tonicesteve,,6,0,9,9,0,10,10,10,0.162194,0.200445,0
MasipAbad,MasipAbad,,2,0,10,10,0,12,12,9,0.225,0.276836,0
ANC_Mossos,ANC_Mossos,,6,33,1,34,33,1,34,14,0.099067,0.108152,2429.383333
terelprieto,terelprieto,,2,0,6,6,0,6,6,9,0.21145,0.250824,0
ramoncotarelo,ramoncotarelo,,1,8,2,10,8,2,10,8,0.218182,0.243733,14156.209037
albertdmcat,albertdmcat,,2,4,2,6,4,2,6,11,0.159907,0.18471,3717.27687
Quimberenguer,Quimberenguer,,2,0,6,6,0,6,6,9,0.223929,0.264962,0
negua597,negua597,,4,0,7,7,0,9,9,9,0.233083,0.277566,0
Hanxxs,Hanxxs,,1,2,3,5,8,3,11,10,0.156907,0.174183,380.106349
locuspolitikus,locuspolitikus,,4,0,9,9,0,13,13,9,0.189831,0.233621,0
EnriqueTgn,EnriqueTgn,,1,1,4,5,1,6,7,9,0.203826,0.245611,22.639286
SansMarcuello,SansMarcuello,,6,0,6,6,0,7,7,1,1,1,0
palaurepublica,palaurepublica,,6,0,6,6,0,8,8,15,0.092149,0.11743,0
CekaKuebel,CekaKuebel,,4,15,7,22,15,8,23,9,0.222581,0.275325,9779.469275
MarioBruned,MarioBruned,,7,0,12,12,0,14,14,12,0.154696,0.203938,0
SiqelEl,SiqelEl,,2,0,6,6,0,8,8,9,0.197434,0.230746,0
Juditpi1,Juditpi1,,7,4,3,7,4,3,7,1,1,1,9
3boigxcatalunya,3boigxcatalunya,,4,0,7,7,0,10,10,9,0.252047,0.299941,0
obffelius,obffelius,,6,0,12,12,0,12,12,8,0.250669,0.305711,0
VidalMoll,VidalMoll,,2,0,5,5,0,5,5,10,0.160231,0.187145,0
BirgittaDE2,BirgittaDE2,,7,5,9,14,9,16,25,8,0.218527,0.261253,1641.791506
MonikaDiethelm,MonikaDiethelm,,7,7,8,15,7,8,15,10,0.190476,0.229155,2673.342571
EvaMaraMaldona2,EvaMaraMaldona2,,6,0,8,8,0,9,9,9,0.206871,0.25519,0
CADCI,CADCI,,7,1,7,8,1,11,12,10,0.168498,0.200019,3509.986544
JofrePilos,JofrePilos,,7,5,6,11,6,9,15,2,0.636364,0.714286,209.409794
Esquerra_ERC,Esquerra_ERC,,5,13,4,17,14,5,19,1,1,1,2289.434524
xerramecat1,xerramecat1,,4,0,7,7,0,7,7,9,0.220205,0.263653,0
Atzucac1,Atzucac1,,1,0,6,6,0,7,7,10,0.178135,0.21699,0
pferrerm,pferrerm,,6,0,8,8,0,9,9,3,0.615385,0.729167,0
Lui_Jana,Lui_Jana,,2,0,5,5,0,5,5,2,0.857143,0.916667,0
paisnotanpetit,paisnotanpetit,,6,2,3,5,2,3,5,1,1,1,5
Sol106360328,Sol106360328,,7,0,11,11,0,14,14,9,0.207958,0.256548,0
Gefero66,Gefero66,,2,0,5,5,0,6,6,10,0.178218,0.212614,0
EsperitLLiure_,EsperitLLiure_,,1,0,5,5,0,6,6,10,0.172886,0.208683,0
JaumeTorras16,JaumeTorras16,,1,3,5,8,3,6,9,1,1,1,9.028571
Praga10948481,Praga10948481,,2,0,6,6,0,7,7,9,0.187036,0.217346,0
unaltredelleida,unaltredelleida,,2,0,12,12,0,13,13,8,0.246018,0.304621,0
joanmtusell,joanmtusell,,2,0,5,5,0,5,5,2,0.857143,0.916667,0
jaestrobaenus,jaestrobaenus,,2,0,5,5,0,5,5,10,0.172586,0.201786,0
Amelycie,Amelycie,,2,0,5,5,0,5,5,11,0.142563,0.16948,0
xevipuix,xevipuix,,2,0,11,11,0,12,12,9,0.225296,0.278226,0
psicolegsanc,psicolegsanc,,5,5,0,5,5,0,5,0,0,0,0
isern_toni,isern_toni,,2,1,4,5,1,5,6,11,0.154146,0.176152,0.5
DomeOrrit,DomeOrrit,,6,0,6,6,0,8,8,4,0.52381,0.712121,0
_NiNetaCat,_NiNetaCat,,1,2,3,5,2,3,5,9,0.226787,0.267337,9193.399867
__llKrisll__,__llKrisll__,,7,0,5,5,0,5,5,11,0.14498,0.175877,0
mbatet,mbatet,,2,0,8,8,0,8,8,9,0.201748,0.242074,0
DaniDvilaro,DaniDvilaro,,6,0,6,6,0,7,7,9,0.218627,0.255429,0
Totestaagafat,Totestaagafat,,2,0,5,5,0,5,5,13,0.118224,0.146406,0
CatalinaBarcel4,CatalinaBarcel4,,2,0,22,22,0,39,39,9,0.221691,0.298781,0
Altafaja1P,Altafaja1P,,4,23,12,35,36,18,54,8,0.244681,0.297265,5756.043431
BadiaSerra7,BadiaSerra7,,4,0,8,8,0,14,14,8,0.250679,0.300696,0
mmontero1151,mmontero1151,,6,0,6,6,0,6,6,2,0.875,0.928571,0
emocionycambio,emocionycambio,,2,0,8,8,0,8,8,10,0.202888,0.243282,0
santaloester,santaloester,,6,63,0,63,64,0,64,0,0,0,0
catals54,catals54,,2,0,6,6,0,6,6,10,0.180402,0.213285,0
uranillo1954,uranillo1954,,7,0,11,11,0,16,16,9,0.233361,0.285353,0
isaacizquierdo2,isaacizquierdo2,,6,3,2,5,3,2,5,1,1,1,4.25
Josepd51,Josepd51,,6,0,5,5,0,9,9,9,0.209459,0.242773,0
RoserTrull,RoserTrull,,6,4,1,5,7,1,8,2,0.666667,0.75,3.5
viscacat,viscacat,,2,0,5,5,0,5,5,10,0.188564,0.21932,0
AsunToldra,AsunToldra,,6,0,6,6,0,6,6,11,0.157538,0.192858,0
lexmarcasvila,lexmarcasvila,,2,0,17,17,0,25,25,8,0.246599,0.306232,0
RosannaRoyoiPla,RosannaRoyoiPla,,5,1,5,6,1,5,6,8,0.232715,0.271657,8067.428644
Saculto333,Saculto333,,2,0,5,5,0,9,9,15,0.09154,0.111505,0
jubilao,jubilao,,6,5,0,5,5,0,5,0,0,0,0
PalmaNeus,PalmaNeus,,6,0,5,5,0,5,5,11,0.159654,0.18814,0
SilviaPolo10,SilviaPolo10,,2,0,9,9,0,10,10,8,0.227984,0.271398,0
jordi_tolosa,jordi_tolosa,,1,2,7,9,2,7,9,9,0.201308,0.238824,120.97619
kaitomanker,kaitomanker,,7,4,8,12,4,9,13,11,0.160161,0.200268,662.5
dnicatala,dnicatala,,6,9,8,17,10,8,18,10,0.179404,0.22075,704.705952
FreeForevercat,FreeForevercat,,4,0,5,5,0,5,5,8,0.228548,0.266387,0
MontserratGA,MontserratGA,,6,0,6,6,0,9,9,12,0.133045,0.167571,0
Lekpo46,Lekpo46,,4,0,5,5,0,5,5,11,0.179056,0.226277,0
Anonymous_Cat0,Anonymous_Cat0,,2,1,5,6,1,5,6,10,0.164482,0.200329,191.355495
CatalanaIndepe1,CatalanaIndepe1,,6,0,5,5,0,6,6,10,0.174874,0.204654,0
euroeuropa,euroeuropa,,5,8,3,11,8,3,11,9,0.190608,0.21895,4931.960379
LliberArt,LliberArt,,7,0,11,11,0,11,11,9,0.218435,0.270725,0
republica_som,republica_som,,7,2,4,6,2,4,6,12,0.147059,0.177708,13.5
floskinborkkum1,floskinborkkum1,,4,0,5,5,0,5,5,10,0.168083,0.19455,0
Wiccaescoladeb1,Wiccaescoladeb1,,2,0,7,7,0,7,7,8,0.328586,0.368358,0
luna555666,luna555666,,6,0,5,5,0,5,5,10,0.206255,0.242495,0
AnnaPJ13,AnnaPJ13,,2,1,4,5,2,5,7,15,0.091118,0.106335,0
9davidgrau,9davidgrau,,4,0,5,5,0,8,8,9,0.212423,0.249758,0
9jrib9,9jrib9,,6,4,10,14,4,10,14,9,0.229236,0.280531,1110.504762
litaborras,litaborras,,7,5,2,7,5,2,7,9,0.179922,0.203356,2013.624045
johierfer,johierfer,,6,0,16,16,0,16,16,8,0.272991,0.339252,0
bisbi44,bisbi44,,3,0,7,7,0,7,7,8,0.261278,0.307503,0
calsojorn10,calsojorn10,,7,0,7,7,0,8,8,9,0.206408,0.246519,0
marc13fornells,marc13fornells,,1,0,5,5,0,5,5,10,0.165077,0.201471,0
garci_roser,garci_roser,,7,2,6,8,2,8,10,9,0.212799,0.250407,1479.928788
toni_m65,toni_m65,,2,0,6,6,0,6,6,9,0.216915,0.256269,0
LZilahy,LZilahy,,7,11,1,12,15,4,19,0,0,0,0
jose_gavalda,jose_gavalda,,0,0,12,12,0,14,14,10,0.195621,0.252753,0
AndresMolinaJi3,AndresMolinaJi3,,2,0,5,5,0,7,7,10,0.185923,0.220934,0
r_maureso,r_maureso,,6,0,12,12,0,13,13,10,0.169834,0.213651,0
llopineiv,llopineiv,,2,0,8,8,0,14,14,9,0.186202,0.220289,0
dr_goian,dr_goian,,2,5,0,5,5,0,5,0,0,0,0
BoschAyza,BoschAyza,,7,0,6,6,0,8,8,10,0.166968,0.195987,0
AnnaRepCat,AnnaRepCat,,2,10,10,20,11,10,21,8,0.257196,0.304972,1139.177514
dateba69mac,dateba69mac,,1,0,8,8,0,12,12,11,0.165094,0.203933,0
MRosagarciag,MRosagarciag,,4,0,11,11,0,14,14,8,0.22557,0.274029,0
lucaquaglia66,lucaquaglia66,,6,0,6,6,0,6,6,10,0.175206,0.206726,0
muxaineta,muxaineta,,2,0,6,6,0,7,7,11,0.153378,0.17993,0
MBaxerias,MBaxerias,,2,0,7,7,0,7,7,9,0.207811,0.248287,0
DolorsNun,DolorsNun,,7,0,5,5,0,9,9,1,1,1,0
Poliol,Poliol,,2,0,5,5,0,5,5,9,0.20219,0.236835,0
JoseLui30038729,JoseLui30038729,,2,0,6,6,0,6,6,10,0.171587,0.206308,0
josepbatllia,josepbatllia,,2,0,5,5,0,7,7,9,0.22249,0.253814,0
laVailet,laVailet,,6,0,5,5,0,6,6,10,0.157745,0.180179,0
Ferran269047911,Ferran269047911,,7,0,6,6,0,10,10,10,0.183931,0.216589,0
CLoresCat,CLoresCat,,4,0,7,7,0,7,7,8,0.214341,0.25841,0
narcinuCAT,narcinuCAT,,1,0,7,7,0,14,14,10,0.186406,0.224808,0
marta47mm,marta47mm,,7,0,7,7,0,19,19,10,0.196242,0.239172,0
JJPPbcn,JJPPbcn,,2,0,14,14,0,15,15,9,0.22411,0.279798,0
L_OBA_,L_OBA_,,2,0,10,10,0,11,11,10,0.168594,0.209366,0
1000boj,1000boj,,7,1,6,7,1,6,7,9,0.211612,0.248716,25.117063
LuciaC67911474,LuciaC67911474,,2,0,6,6,0,6,6,10,0.164881,0.192866,0
montarmat,montarmat,,4,0,8,8,0,9,9,9,0.213241,0.257825,0
XARLIPIU,XARLIPIU,,6,1,9,10,1,12,13,10,0.185532,0.231978,44.316667
osbru1,osbru1,,7,0,7,7,0,18,18,13,0.122512,0.154512,0
jbcncat,jbcncat,,2,0,7,7,0,7,7,11,0.164685,0.202525,0
mmillanclosa,mmillanclosa,,1,5,8,13,5,8,13,9,0.236099,0.289123,11249.237897
biblioaprenent,biblioaprenent,,2,0,7,7,0,7,7,9,0.214838,0.254201,0
rmplanes1,rmplanes1,,4,0,6,6,0,8,8,8,0.265326,0.31386,0
MnicaRebullCome,MnicaRebullCome,,4,42,14,56,64,15,79,8,0.261611,0.323581,51394.05021
parecollons,parecollons,,2,0,5,5,0,6,6,1,1,1,0
FerranMaulet,FerranMaulet,,7,0,7,7,0,8,8,13,0.125,0.160919,0
Barea_tel,Barea_tel,,2,1,8,9,1,10,11,10,0.174733,0.21948,46.430556
DniaGom,DniaGom,,2,0,7,7,0,7,7,11,0.154146,0.183126,0
Rosa32481251,Rosa32481251,,6,0,7,7,0,7,7,9,0.231026,0.279196,0
triadefvg,triadefvg,,2,0,6,6,0,9,9,10,0.158015,0.182981,0
PacoEscudero12,PacoEscudero12,,4,2,5,7,2,6,8,8,0.257703,0.293879,6400.636129
PositivaPersona,PositivaPersona,,7,0,7,7,0,9,9,11,0.167372,0.208487,0
desferr,desferr,,2,0,10,10,0,12,12,8,0.251812,0.301871,0
PepVila4,PepVila4,,2,0,6,6,0,6,6,13,0.122188,0.151418,0
Mutenrotxi,Mutenrotxi,,6,13,8,21,14,8,22,10,0.183267,0.219437,5330.385728
FastRiderY,FastRiderY,,1,0,5,5,0,7,7,9,0.213241,0.259677,0
jordixyoli,jordixyoli,,1,0,5,5,0,5,5,1,1,1,0
riverolavictor,riverolavictor,,3,3,3,6,3,3,6,9,0.210008,0.237456,416.464683
JonInarritu,JonInarritu,,1,9,0,9,9,0,9,0,0,0,0
deya_deya99,deya_deya99,,6,0,8,8,0,9,9,10,0.168389,0.203869,0
quelcolom,quelcolom,,1,0,8,8,0,9,9,9,0.218553,0.26394,0
jeronicat,jeronicat,,2,0,6,6,0,6,6,10,0.189466,0.223827,0
LauraBorras,LauraBorras,,6,3,4,7,3,4,7,2,0.7,0.785714,20.45
annabcncat,annabcncat,,7,0,5,5,0,6,6,12,0.152449,0.192357,0
MadxoraRoures,MadxoraRoures,,4,10,5,15,11,8,19,9,0.231738,0.27526,2609.135793
CErauso,CErauso,,2,1,4,5,1,6,7,2,0.833333,0.9,7
ElFairy3,ElFairy3,,1,5,0,5,5,0,5,0,0,0,0
Maites660816,Maites660816,,7,0,5,5,0,7,7,13,0.12208,0.149548,0
PereDempeus,PereDempeus,,2,0,5,5,0,5,5,3,0.555556,0.7,0
Saltencaverdneg,Saltencaverdneg,,5,0,5,5,0,5,5,2,0.857143,0.916667,0
petiua,petiua,,2,0,12,12,0,15,15,9,0.215397,0.265147,0
nanasalvador,nanasalvador,,5,5,1,6,6,1,7,0,0,0,0
sakurakyudo17,sakurakyudo17,,7,0,8,8,0,9,9,9,0.220016,0.259267,0
PereRF,PereRF,,4,11,3,14,12,4,16,1,1,1,156.992532
JoanLlorens5,JoanLlorens5,,2,0,5,5,0,7,7,2,0.777778,0.857143,0
Therminattor,Therminattor,,1,0,6,6,0,6,6,1,1,1,0
Xavi86264215,Xavi86264215,,4,0,7,7,0,7,7,9,0.232888,0.276687,0
david_nomes,david_nomes,,2,0,6,6,0,6,6,15,0.093917,0.125404,0
fuste_marina,fuste_marina,,2,0,5,5,0,5,5,10,0.179987,0.210928,0
teresasoley,teresasoley,,4,0,5,5,0,5,5,9,0.227049,0.270096,0
Gusgus6778,Gusgus6778,,6,0,6,6,0,6,6,9,0.220893,0.261747,0
sanes_marta,sanes_marta,,6,0,5,5,0,5,5,13,0.122566,0.151949,0
AntonioMarias2,AntonioMarias2,,6,0,7,7,0,8,8,11,0.166567,0.201743,0
pilarVives2,pilarVives2,,2,0,5,5,0,5,5,9,0.216745,0.253319,0
28aOriol,28aOriol,,5,4,8,12,4,9,13,10,0.161782,0.194381,2268.21015
Adelita49455612,Adelita49455612,,2,0,8,8,0,12,12,13,0.12551,0.168046,0
Pjsango,Pjsango,,1,4,4,8,4,4,8,10,0.159379,0.18248,108.162879
Ref1Oct17,Ref1Oct17,,2,0,6,6,0,6,6,11,0.166966,0.198439,0
Ana99544117,Ana99544117,,4,0,6,6,0,7,7,9,0.217767,0.26173,0
ferran2val,ferran2val,,6,0,5,5,0,6,6,10,0.160116,0.185064,0
324cat,324cat,,1,6,0,6,7,0,7,0,0,0,0
merce_canto,merce_canto,,6,0,6,6,0,6,6,12,0.132981,0.16727,0
desferrapertu,desferrapertu,,2,0,5,5,0,5,5,9,0.209848,0.254004,0
silviaalatra,silviaalatra,,6,0,8,8,0,8,8,11,0.156409,0.194504,0
ElPakiPunkiSEDR,ElPakiPunkiSEDR,,6,4,1,5,4,1,5,1,1,1,0.583333
Mireiuski_Al,Mireiuski_Al,,3,0,13,13,0,17,17,9,0.233953,0.29476,0
roserbonet,roserbonet,,7,0,6,6,0,6,6,10,0.165871,0.198802,0
portet_bruguera,portet_bruguera,,6,7,2,9,7,2,9,12,0.137674,0.165583,317.335823
teta54bis,teta54bis,,2,0,8,8,0,11,11,1,1,1,0
thinkcatalonia,thinkcatalonia,,7,0,8,8,0,10,10,13,0.123172,0.157468,0
jcecatalunya,jcecatalunya,,4,2,9,11,2,9,11,9,0.196733,0.234343,115.559524
jsferrate,jsferrate,,1,0,5,5,0,7,7,9,0.228916,0.27427,0
vadortitus,vadortitus,,6,0,17,17,0,23,23,10,0.216718,0.300738,0
lluisgibert,lluisgibert,,2,4,1,5,4,1,5,9,0.184863,0.202735,1458.454221
Nil_Cat1,Nil_Cat1,,6,0,7,7,0,8,8,10,0.189208,0.231654,0
GayMontserrat,GayMontserrat,,6,0,5,5,0,5,5,13,0.122512,0.151348,0
Cuquileti1,Cuquileti1,,7,0,5,5,0,9,9,13,0.122242,0.149713,0
tere_pey,tere_pey,,1,1,5,6,1,6,7,9,0.210008,0.24576,11.5
dolorsesteveco,dolorsesteveco,,7,0,6,6,0,10,10,9,0.200722,0.23942,0
issr5_issa,issr5_issa,,3,26,2,28,30,2,32,11,0.158166,0.178314,1213.846876
QuiqueSchenker,QuiqueSchenker,,2,0,5,5,0,8,8,9,0.186031,0.213294,0
Monicapr04,Monicapr04,,1,1,5,6,1,5,6,2,0.592593,0.65625,3.885714
YelnikoffMikael,YelnikoffMikael,,1,13,10,23,19,13,32,1,1,1,464.010029
rosadiezglez,rosadiezglez,,1,12,0,12,13,0,13,0,0,0,0
solisobra,solisobra,,7,0,6,6,0,10,10,13,0.122404,0.153303,0
madaeslava,madaeslava,,1,0,7,7,0,9,9,3,0.583333,0.714286,0
Jolavica,Jolavica,,6,0,7,7,0,7,7,13,0.12472,0.164168,0
EBruixa,EBruixa,,1,0,7,7,0,9,9,9,0.230641,0.277988,0
vincaibaladre,vincaibaladre,,4,0,9,9,0,11,11,9,0.202042,0.247543,0
Emiliguz36,Emiliguz36,,2,0,12,12,0,12,12,8,0.252277,0.301019,0
GloriaSS2014,GloriaSS2014,,6,1,6,7,1,6,7,9,0.206538,0.237998,172.530952
esperanttot,esperanttot,,6,0,7,7,0,8,8,13,0.122026,0.152747,0
annam1181or,annam1181or,,4,1,7,8,1,8,9,8,0.316357,0.356284,0
PakiEgeaAponte,PakiEgeaAponte,,7,0,6,6,0,9,9,10,0.174323,0.205971,0
catalajoanam,catalajoanam,,6,0,16,16,0,16,16,9,0.225781,0.295165,0
Olga42830864,Olga42830864,,1,4,10,14,4,15,19,8,0.248873,0.303032,7568.48684
guifre2053,guifre2053,,2,0,13,13,0,16,16,9,0.210167,0.268694,0
PileteJosefine,PileteJosefine,,6,0,9,9,0,10,10,8,0.24978,0.302213,0
petruscandin,petruscandin,,6,0,5,5,0,5,5,11,0.160622,0.189943,0
Mobilisinmobil1,Mobilisinmobil1,,7,0,5,5,0,5,5,13,0.121812,0.148259,0
HoracioNPerez,HoracioNPerez,,2,1,5,6,1,5,6,9,0.184369,0.214996,1716.451378
xavierfarrero,xavierfarrero,,1,0,6,6,0,7,7,9,0.259606,0.313277,0
madovi11957,madovi11957,,7,0,5,5,0,5,5,3,0.625,0.733333,0
KuriosCat,KuriosCat,,6,2,3,5,2,3,5,10,0.185235,0.209931,501.024675
Amarokian,Amarokian,,6,0,8,8,0,9,9,9,0.236887,0.282276,0
AntoniFerrer2,AntoniFerrer2,,7,0,5,5,0,5,5,10,0.163433,0.192933,0
raidtxu,raidtxu,,2,9,0,9,9,0,9,0,0,0,0
IldaGuCan7,IldaGuCan7,,7,0,5,5,0,5,5,9,0.208427,0.240448,0
BalladaresEnric,BalladaresEnric,,2,0,8,8,0,9,9,11,0.155269,0.188766,0
Francesc_BP,Francesc_BP,,7,0,5,5,0,13,13,13,0.123221,0.15376,0
Jllibertat1,Jllibertat1,,3,0,8,8,0,8,8,8,0.217799,0.258615,0
CuberoLuis,CuberoLuis,,2,0,5,5,0,5,5,2,0.857143,0.916667,0
Isaac__am,Isaac__am,,6,0,11,11,0,13,13,10,0.215777,0.270814,0
MerceVidalIbae1,MerceVidalIbae1,,7,0,5,5,0,7,7,10,0.188435,0.220923,0
Toni_Caballe,Toni_Caballe,,7,0,5,5,0,10,10,13,0.1229,0.152322,0
Tamborras,Tamborras,,1,0,14,14,0,18,18,8,0.245555,0.30679,0
JanosocLady,JanosocLady,,4,59,5,64,61,6,67,9,0.216641,0.258305,10413.090425
Splth32,Splth32,,2,0,7,7,0,9,9,10,0.165476,0.198869,0
Geno_SG,Geno_SG,,4,1,4,5,1,4,5,9,0.2216,0.257376,125.039683
royo1_royo,royo1_royo,,4,3,8,11,3,9,12,9,0.222669,0.267121,180.574747
teuvidal,teuvidal,,2,0,6,6,0,6,6,11,0.140467,0.16594,0
GalileaPiero,GalileaPiero,,1,0,6,6,0,12,12,9,0.196733,0.230424,0
juditvida2,juditvida2,,6,0,5,5,0,5,5,13,0.122026,0.15236,0
elboncatalanet,elboncatalanet,,2,0,5,5,0,5,5,11,0.163422,0.193382,0
Xabingo,Xabingo,,7,0,5,5,0,5,5,9,0.206871,0.237847,0
BroggiElisa,BroggiElisa,,4,0,6,6,0,9,9,9,0.191563,0.224632,0
cmoratuxans,cmoratuxans,,6,0,6,6,0,6,6,13,0.122575,0.15469,0
frubiover,frubiover,,2,0,5,5,0,8,8,11,0.149487,0.182227,0
IsabelGrau4,IsabelGrau4,,6,0,9,9,0,12,12,10,0.180691,0.22383,0
Roger_CdV,Roger_CdV,,2,8,0,8,8,0,8,0,0,0,0
allioli5,allioli5,,6,0,5,5,0,5,5,13,0.122296,0.150636,0
manelrawal,manelrawal,,2,0,5,5,0,5,5,13,0.122134,0.149613,0
cos1alatac,cos1alatac,,7,0,7,7,0,9,9,13,0.122893,0.155902,0
carles_gavila,carles_gavila,,7,0,5,5,0,6,6,13,0.122512,0.150992,0
Tossut_RiTA,Tossut_RiTA,,0,20,6,26,30,32,62,10,0.183511,0.220685,636.154401
jordisendra,jordisendra,,6,9,4,13,10,5,15,11,0.157895,0.194958,23114.339688
CDRFarro,CDRFarro,,3,11,0,11,20,0,20,0,0,0,0
corremons,corremons,,4,0,6,6,0,6,6,9,0.232773,0.275218,0
pacoturegano001,pacoturegano001,,1,0,5,5,0,8,8,10,0.172157,0.201915,0
juristestgn,juristestgn,,7,22,1,23,32,1,33,1,1,1,12.5
6q_siscu,6q_siscu,,7,0,6,6,0,10,10,8,0.24535,0.280243,0
ModestAlbert,ModestAlbert,,2,0,5,5,0,5,5,13,0.121812,0.149163,0
_architekt,_architekt,,3,0,5,5,0,5,5,10,0.19576,0.229051,0
nb1Oct,nb1Oct,,7,0,8,8,0,12,12,13,0.123111,0.158664,0
PurgatoriPop,PurgatoriPop,,2,0,5,5,0,5,5,9,0.218454,0.254467,0
DolsR,DolsR,,6,0,5,5,0,5,5,10,0.166267,0.192712,0
anacon21,anacon21,,2,0,8,8,0,8,8,11,0.155394,0.19342,0
cuarda29,cuarda29,,2,0,9,9,0,10,10,2,0.846154,0.909091,0
angelsmarco444,angelsmarco444,,6,0,16,16,0,18,18,8,0.258845,0.325874,0
TSivatte,TSivatte,,6,0,5,5,0,6,6,12,0.151201,0.182862,0
DespertaFerro11,DespertaFerro11,,6,0,12,12,0,15,15,9,0.230258,0.287104,0
Jorgellao1,Jorgellao1,,7,0,6,6,0,7,7,13,0.123002,0.154597,0
mangelsjimenez,mangelsjimenez,,7,0,9,9,0,15,15,9,0.205033,0.25815,0
indignindigente,indignindigente,,7,0,9,9,0,17,17,9,0.212261,0.254402,0
neuscasanovas,neuscasanovas,,4,0,10,10,0,14,14,7,0.279678,0.327115,0
Tesa03800368,Tesa03800368,,2,0,7,7,0,7,7,9,0.211568,0.248473,0
falduko,falduko,,7,1,5,6,1,7,8,11,0.154922,0.186725,22.566667
BrokilisOver,BrokilisOver,,2,0,6,6,0,6,6,9,0.216406,0.257866,0
JoanFra82923050,JoanFra82923050,,2,0,5,5,0,6,6,9,0.214011,0.260208,0
joanlluisg,joanlluisg,,6,0,6,6,0,6,6,11,0.170567,0.208637,0
Medard636476034,Medard636476034,,7,0,5,5,0,6,6,13,0.121758,0.148194,0
rafempm,rafempm,,1,0,6,6,0,7,7,9,0.219243,0.264675,0
sribas9,sribas9,,2,0,5,5,0,5,5,11,0.161516,0.191447,0
jordib66,jordib66,,2,0,5,5,0,6,6,1,1,1,0
ramirp,ramirp,,1,7,0,7,7,0,7,0,0,0,0
pitusihara,pitusihara,,6,0,5,5,0,5,5,11,0.157297,0.190773,0
TerraDefensor,TerraDefensor,,2,0,5,5,0,5,5,10,0.157745,0.180875,0
JoanBay,JoanBay,,7,0,10,10,0,14,14,9,0.218972,0.26877,0
MarcMateos,MarcMateos,,7,0,9,9,0,10,10,9,0.21275,0.254643,0
arisoenric,arisoenric,,6,0,5,5,0,6,6,13,0.124104,0.154601,0
XavimacuX,XavimacuX,,6,0,13,13,0,13,13,9,0.248658,0.302918,0
annamariasastre,annamariasastre,,6,0,6,6,0,6,6,10,0.180339,0.217813,0
DDomene,DDomene,,4,1,5,6,1,6,7,9,0.198851,0.233246,109.732143
heras_jordi,heras_jordi,,6,0,7,7,0,7,7,13,0.125226,0.160818,0
P1m2P3,P1m2P3,,6,3,4,7,3,4,7,13,0.123009,0.150374,269.819444
morera_ingles,morera_ingles,,2,0,6,6,0,7,7,9,0.203663,0.242839,0
lcc_luisa,lcc_luisa,,6,0,5,5,0,6,6,9,0.215611,0.261861,0
Elqetvaigdir,Elqetvaigdir,,7,0,17,17,0,25,25,9,0.195789,0.254138,0
Pipu1975,Pipu1975,,0,0,5,5,0,5,5,9,0.205948,0.247744,0
juditrmeu,juditrmeu,,7,4,4,8,4,4,8,11,0.176583,0.209498,3370.046465
mpb513,mpb513,,6,0,7,7,0,7,7,12,0.152281,0.197471,0
FGuinness64,FGuinness64,,3,0,6,6,0,9,9,10,0.202909,0.242726,0
compartiropini1,compartiropini1,,2,0,6,6,0,6,6,10,0.186281,0.218571,0
MarGut77567783,MarGut77567783,,6,0,9,9,0,10,10,9,0.251818,0.297896,0
miki_gtr,miki_gtr,,7,0,9,9,0,10,10,13,0.126196,0.165986,0
jailedcatalanet,jailedcatalanet,,6,0,6,6,0,6,6,9,0.209057,0.243241,0
martamu4,martamu4,,6,0,8,8,0,8,8,10,0.184421,0.222019,0
Tetsuo41,Tetsuo41,,7,1,15,16,1,20,21,9,0.24912,0.317336,151.867063
BernaMadrid3,BernaMadrid3,,7,0,6,6,0,6,6,11,0.153931,0.181055,0
Palaritxi1,Palaritxi1,,6,0,5,5,0,6,6,2,0.857143,0.916667,0
milfordedge,milfordedge,,3,6,1,7,6,1,7,0,0,0,0
Poxci53,Poxci53,,2,0,10,10,0,12,12,9,0.228548,0.276987,0
outsiderthor,outsiderthor,,4,1,4,5,1,5,6,10,0.177223,0.204318,222.333333
hacafu,hacafu,,2,0,5,5,0,5,5,2,0.857143,0.916667,0
LluisBanyoles,LluisBanyoles,,2,2,11,13,2,11,13,8,0.245844,0.299627,407.164683
xineta8,xineta8,,2,0,6,6,0,6,6,9,0.199568,0.238688,0
LluisMacabeu,LluisMacabeu,,6,0,8,8,0,10,10,9,0.192629,0.230067,0
Sam37162714,Sam37162714,,7,0,5,5,0,7,7,9,0.201154,0.235679,0
SantacreuRosa,SantacreuRosa,,4,0,11,11,0,15,15,9,0.226863,0.277112,0
joanbeia,joanbeia,,2,0,5,5,0,5,5,15,0.091813,0.113009,0
IsabelPrezVale2,IsabelPrezVale2,,7,0,7,7,0,12,12,2,0.769231,0.85,0
PinyolJordi,PinyolJordi,,7,0,5,5,0,7,7,9,0.216342,0.254177,0
InesArrimadas,InesArrimadas,,1,10,0,10,11,0,11,0,0,0,0
Mel25472905,Mel25472905,,7,0,7,7,0,12,12,2,0.733333,0.818182,0
alfsilvan,alfsilvan,,7,1,5,6,1,5,6,11,0.169221,0.205868,254.466234
Kostas6969K,Kostas6969K,,2,0,5,5,0,5,5,12,0.135833,0.160082,0
FrancJfarmo,FrancJfarmo,,6,0,11,11,0,13,13,8,0.252047,0.301844,0
Cal_Ganxet,Cal_Ganxet,,4,0,5,5,0,7,7,8,0.230833,0.269821,0
EnigmaheartTrue,EnigmaheartTrue,,4,0,7,7,0,8,8,8,0.229819,0.272081,0
FachoniPP,FachoniPP,,2,10,0,10,10,0,10,0,0,0,0
saribes,saribes,,4,7,3,10,10,8,18,3,0.466667,0.571429,34.5
JosebaTrevino,JosebaTrevino,,7,0,6,6,0,9,9,1,1,1,0
JoventGracia,JoventGracia,,5,6,0,6,6,0,6,0,0,0,0
juliangrau,juliangrau,,7,0,6,6,0,6,6,9,0.194386,0.224927,0
Maqueill4,Maqueill4,,4,2,4,6,2,4,6,9,0.20718,0.231736,1004.527092
jordigraur,jordigraur,,5,0,5,5,0,9,9,11,0.139196,0.162086,0
CdrIGD,CdrIGD,,7,2,4,6,2,7,9,1,1,1,12.7
HomsJoaquim,HomsJoaquim,,6,0,7,7,0,7,7,9,0.208427,0.252719,0
v1sens,v1sens,,6,10,0,10,10,0,10,0,0,0,0
joanaduc,joanaduc,,6,1,5,6,11,15,26,9,0.180221,0.207709,0
ivanvoinitski,ivanvoinitski,,6,0,6,6,0,6,6,8,0.225754,0.262601,0
AnnaTresCatorze,AnnaTresCatorze,,7,0,12,12,0,30,30,13,0.114053,0.157148,0
obulco2014,obulco2014,,1,2,5,7,2,6,8,3,0.529412,0.666667,0.433333
PalmiraTercera,PalmiraTercera,,2,0,6,6,0,7,7,2,0.8,0.875,0
jcobegua,jcobegua,,2,0,5,5,0,5,5,2,0.857143,0.916667,0
vallmy,vallmy,,7,0,6,6,0,11,11,11,0.148267,0.179314,0
Krick__in_inde_,Krick__in_inde_,,6,0,5,5,0,6,6,10,0.186784,0.223622,0
XaioTro,XaioTro,,7,13,3,16,13,5,18,9,0.187669,0.212147,959.095238
peptorra10,peptorra10,,6,0,5,5,0,6,6,8,0.214729,0.252213,0
PereSenye,PereSenye,,1,3,2,5,3,2,5,1,1,1,1.2
david_ropero2,david_ropero2,,6,0,6,6,0,7,7,9,0.204428,0.240382,0
ManuB72179071,ManuB72179071,,1,5,0,5,5,0,5,0,0,0,0
mataro60,mataro60,,6,0,5,5,0,5,5,10,0.172586,0.202001,0
lamarta,lamarta,,5,0,5,5,0,6,6,2,0.692308,0.777778,0
lothlertu,lothlertu,,6,0,13,13,0,17,17,8,0.243409,0.301156,0
KRLS,KRLS,,6,573,0,573,810,0,810,0,0,0,0
xaviercatal,xaviercatal,,4,0,5,5,0,5,5,8,0.229305,0.263632,0
RibesAlicia,RibesAlicia,,1,0,18,18,0,21,21,8,0.281157,0.359553,0
Toms94851720,Toms94851720,,1,0,5,5,0,5,5,12,0.148845,0.179742,0
sysco5,sysco5,,1,0,5,5,0,5,5,11,0.151025,0.176083,0
nuria_nmfabrega,nuria_nmfabrega,,7,0,12,12,0,15,15,8,0.24216,0.295054,0
garcia_lozoya,garcia_lozoya,,7,3,2,5,3,3,6,1,1,1,23.166667
MontseGarciaCa1,MontseGarciaCa1,,6,0,6,6,0,6,6,9,0.236147,0.274688,0
flocdeneu,flocdeneu,,3,0,8,8,0,11,11,9,0.2159,0.258739,0
EsterRubio2,EsterRubio2,,4,0,7,7,0,7,7,9,0.203228,0.245674,0
josepvillon,josepvillon,,7,0,5,5,0,10,10,15,0.091631,0.111833,0
encaputxada,encaputxada,,1,3,2,5,3,2,5,1,1,1,48.398662
karewtos,karewtos,,2,0,6,6,0,8,8,9,0.200861,0.233114,0
teresa_just,teresa_just,,2,0,5,5,0,7,7,11,0.169005,0.208739,0
Postveritatum,Postveritatum,,3,0,10,10,0,10,10,8,0.239412,0.293639,0
huguet_gabriel,huguet_gabriel,,2,0,6,6,0,6,6,12,0.124832,0.152639,0
MartSchoonhoven,MartSchoonhoven,,3,0,7,7,0,8,8,10,0.19146,0.227651,0
remeiisabel,remeiisabel,,6,0,6,6,0,6,6,8,0.243409,0.288495,0
sikokosmik,sikokosmik,,2,7,4,11,7,4,11,11,0.141909,0.163624,357.396465
lluisaaguilera,lluisaaguilera,,1,1,5,6,2,5,7,13,0.123166,0.155956,5.590079
neus45,neus45,,6,0,5,5,0,5,5,1,1,1,0
jfaleixandri,jfaleixandri,,0,13,3,16,21,3,24,11,0.15602,0.181535,6.3
pancracieta,pancracieta,,4,10,0,10,11,0,11,0,0,0,0
Antorbufor,Antorbufor,,2,4,1,5,4,1,5,1,1,1,8
Radiopolli,Radiopolli,,2,43,0,43,47,0,47,0,0,0,0
sindicatsame,sindicatsame,,1,1,7,8,1,10,11,9,0.194503,0.236755,4580.788925
JACS_JaumeACS,JACS_JaumeACS,,1,8,1,9,8,1,9,1,1,1,189.359524
anna_dalloway,anna_dalloway,,3,0,6,6,0,6,6,10,0.192176,0.226723,0
Caminant_BCN,Caminant_BCN,,6,1,5,6,2,6,8,10,0.175539,0.214508,15.533333
46Rosa46,46Rosa46,,6,0,5,5,0,6,6,9,0.204112,0.247125,0
MossosXdemos,MossosXdemos,,2,44,1,45,53,2,55,14,0.09896,0.108052,4008.026984
LaRepCat,LaRepCat,,5,2,3,5,2,4,6,11,0.138554,0.156202,10303.511111
el_pais,el_pais,,1,6,0,6,12,0,12,0,0,0,0
BlocDempeus,BlocDempeus,,7,9,1,10,11,1,12,13,0.10948,0.120152,6897.830159
papachambo1,papachambo1,,1,0,7,7,0,7,7,8,0.24087,0.284988,0
jordicanals,jordicanals,,6,1,5,6,3,8,11,2,0.833333,0.9,0
estermartia,estermartia,,5,0,7,7,0,7,7,10,0.17871,0.214829,0
felipdeflandes,felipdeflandes,,3,0,5,5,0,7,7,10,0.190021,0.22157,0
elLLOP9,elLLOP9,,6,0,7,7,0,7,7,10,0.168792,0.200815,0
Montcau,Montcau,,6,17,5,22,19,7,26,12,0.151316,0.190337,4901.493464
JuntsXLH,JuntsXLH,,6,3,8,11,3,16,19,12,0.151982,0.194736,796.75
lourdesriberaan,lourdesriberaan,,6,0,5,5,0,6,6,9,0.21275,0.247367,0
LLeiDI_DI,LLeiDI_DI,,1,1,9,10,1,10,11,2,0.8,0.875,7.166667
LluisDeMar,LluisDeMar,,6,0,5,5,0,5,5,13,0.12235,0.150676,0
AlacidSergi,AlacidSergi,,7,0,7,7,0,7,7,2,0.818182,0.888889,0
FERMINATX,FERMINATX,,2,0,5,5,0,6,6,9,0.201158,0.234668,0
ThankYouFromCat,ThankYouFromCat,,6,14,3,17,14,3,17,3,0.555556,0.666667,71.75
guasch22,guasch22,,6,0,8,8,0,10,10,1,1,1,0
LaMarea7,LaMarea7,,2,12,1,13,13,1,14,10,0.163507,0.189762,1565.068543
laxarxaxanante1,laxarxaxanante1,,1,5,0,5,10,0,10,0,0,0,0
Montorpat,Montorpat,,7,0,5,5,0,10,10,13,0.111604,0.135833,0
Pere_Clota,Pere_Clota,,6,20,4,24,22,4,26,11,0.150985,0.183212,5714.798586
fvilarrubi,fvilarrubi,,2,0,6,6,0,6,6,9,0.228926,0.26981,0
BcnDesencantat,BcnDesencantat,,6,2,7,9,2,9,11,10,0.206385,0.251108,140.946032
orriolsderipoll,orriolsderipoll,,6,11,0,11,11,0,11,0,0,0,0
zeroocool1971,zeroocool1971,,6,0,5,5,0,6,6,11,0.143226,0.173833,0
JM_Segarra,JM_Segarra,,6,0,5,5,0,7,7,12,0.138086,0.172502,0
MiquelPascualC1,MiquelPascualC1,,7,0,9,9,0,13,13,2,0.909091,0.95,0
lalidieta,lalidieta,,6,0,5,5,0,5,5,12,0.132917,0.164583,0
arnaucabeza,arnaucabeza,,7,1,14,15,1,21,22,12,0.147043,0.209627,273.5
georgina_pou,georgina_pou,,6,3,4,7,3,4,7,13,0.132756,0.164394,1625.900534
joanagabarrof,joanagabarrof,,6,0,14,14,0,16,16,12,0.157095,0.220692,0
Aponsm,Aponsm,,6,0,5,5,0,5,5,1,1,1,0
monterhusmore,monterhusmore,,2,0,5,5,0,5,5,11,0.163905,0.192133,0
gar_manchon,gar_manchon,,2,1,4,5,1,4,5,9,0.191696,0.225066,8.2
lliurecattuga,lliurecattuga,,2,0,7,7,0,7,7,10,0.187036,0.225953,0
GostRita,GostRita,,0,0,5,5,0,8,8,10,0.184298,0.223198,0
Santi_040662,Santi_040662,,6,0,10,10,0,11,11,2,0.916667,0.954545,0
ElCensurat,ElCensurat,,2,5,0,5,5,0,5,0,0,0,0
omnium,omnium,,7,48,1,49,48,6,54,1,1,1,193.20119
EPascualLagunas,EPascualLagunas,,2,0,9,9,0,10,10,10,0.179949,0.219741,0
ideafix5,ideafix5,,2,0,7,7,0,7,7,11,0.153974,0.183145,0
manuelasoto16,manuelasoto16,,2,3,4,7,3,4,7,11,0.16707,0.198143,143.041667
coach_en_viu,coach_en_viu,,2,3,6,9,3,6,9,9,0.226115,0.25849,318.036905
SeveZubiri,SeveZubiri,,4,2,6,8,2,7,9,9,0.26011,0.308855,522.172222
45c32378c34f499,45c32378c34f499,,6,0,6,6,0,6,6,9,0.220366,0.260062,0
CAT_2019_INDEPE,CAT_2019_INDEPE,,7,0,5,5,0,9,9,13,0.127298,0.15814,0
Blancr1,Blancr1,,6,1,5,6,1,5,6,10,0.177337,0.20506,14.42619
Trucguanyador,Trucguanyador,,2,0,5,5,0,5,5,2,0.777778,0.857143,0
CarlesSueiras,CarlesSueiras,,6,0,6,6,0,6,6,10,0.201162,0.23711,0
cantonalista17,cantonalista17,,7,0,5,5,0,8,8,2,0.857143,0.916667,0
paco_santero,paco_santero,,3,1,4,5,1,4,5,13,0.111961,0.135434,593.5
MyriamA78,MyriamA78,,7,0,6,6,0,8,8,10,0.16305,0.191357,0
Catalana17141,Catalana17141,,0,0,6,6,0,6,6,9,0.224655,0.268662,0
Elisenda66,Elisenda66,,1,0,9,9,0,12,12,8,0.232636,0.276516,0
XavierSolerT,XavierSolerT,,6,0,7,7,0,7,7,12,0.132697,0.165889,0
annuskaodena,annuskaodena,,1,3,2,5,3,2,5,2,0.75,0.833333,540.543146
CarladelCarme,CarladelCarme,,4,6,6,12,6,7,13,9,0.229617,0.273056,1444.388167
BURBU05362987,BURBU05362987,,7,1,4,5,1,4,5,9,0.203527,0.233375,0
gatetew,gatetew,,1,0,6,6,0,7,7,1,1,1,0
griscuenc,griscuenc,,4,0,6,6,0,8,8,9,0.231605,0.273136,0
eva5lobitos,eva5lobitos,,2,15,0,15,15,0,15,0,0,0,0
efernandezo2010,efernandezo2010,,2,0,5,5,0,5,5,13,0.123002,0.155555,0
Fondesfam,Fondesfam,,7,0,7,7,0,9,9,9,0.221338,0.263503,0
Boladevidre,Boladevidre,,1,9,5,14,9,5,14,10,0.174733,0.19991,776.043759
TarragonaCdr,TarragonaCdr,,7,2,3,5,4,4,8,3,0.583333,0.690476,4
Algarsal65,Algarsal65,,7,0,5,5,0,7,7,15,0.091901,0.114231,0
EcramOllirium,EcramOllirium,,7,0,8,8,0,13,13,8,0.207646,0.247078,0
ester0961,ester0961,,4,0,9,9,0,12,12,9,0.243196,0.293022,0
miquel303marti,miquel303marti,,6,0,5,5,0,6,6,10,0.187542,0.219073,0
frankieporras,frankieporras,,2,0,8,8,0,8,8,10,0.181132,0.223552,0
ElisabetRegi,ElisabetRegi,,6,0,5,5,0,5,5,11,0.157745,0.188773,0
Cristin60957335,Cristin60957335,,2,0,5,5,0,5,5,13,0.120259,0.152549,0
mjanesam_jan,mjanesam_jan,,2,0,5,5,0,5,5,9,0.193301,0.22795,0
ercvall,ercvall,,5,9,3,12,9,3,12,3,0.5,0.633333,747.869612
albertsalavila,albertsalavila,,2,11,0,11,11,0,11,0,0,0,0
payuviu,payuviu,,2,0,7,7,0,7,7,8,0.235196,0.278293,0
JoMarina55,JoMarina55,,2,0,5,5,0,6,6,11,0.153633,0.179363,0
Susanje64402042,Susanje64402042,,4,0,5,5,0,5,5,9,0.222045,0.260716,0
serra_merce,serra_merce,,7,0,5,5,0,9,9,2,0.727273,0.8125,0
SummitsTrading,SummitsTrading,,6,7,1,8,7,1,8,0,0,0,0
silviaaregall,silviaaregall,,6,0,5,5,0,5,5,1,1,1,0
Coconats19,Coconats19,,6,0,6,6,0,6,6,2,0.8,0.875,0
esteren3onidos,esteren3onidos,,2,0,6,6,0,8,8,1,1,1,0
EnricPujol1960,EnricPujol1960,,7,0,6,6,0,6,6,9,0.235745,0.272908,0
Aina26808525,Aina26808525,,6,0,13,13,0,14,14,11,0.166867,0.230795,0
Xoriguer1,Xoriguer1,,2,0,7,7,0,9,9,10,0.180574,0.215862,0
DoctorMoasia,DoctorMoasia,,1,2,3,5,2,3,5,1,1,1,2
KRLeS9,KRLeS9,,7,0,7,7,0,11,11,14,0.100874,0.128218,0
Monicanpl,Monicanpl,,7,4,1,5,4,1,5,0,0,0,0
NuriaAmetller,NuriaAmetller,,6,0,6,6,0,6,6,9,0.199571,0.238543,0
Luisaloguisa,Luisaloguisa,,2,1,6,7,1,6,7,9,0.209389,0.245769,26
JosepMariaGF,JosepMariaGF,,2,0,6,6,0,6,6,15,0.092057,0.116449,0
VilanaMerce,VilanaMerce,,6,0,9,9,0,12,12,10,0.179987,0.219741,0
CdrRoda,CdrRoda,,7,6,0,6,6,0,6,0,0,0,0
NoPassaran5,NoPassaran5,,2,6,0,6,6,0,6,0,0,0,0
RichiPericles,RichiPericles,,2,0,5,5,0,5,5,10,0.18895,0.224221,0
captivus45,captivus45,,2,0,5,5,0,5,5,3,0.666667,0.791667,0
PascualPanico,PascualPanico,,4,7,0,7,9,0,9,0,0,0,0
Granollacs,Granollacs,,7,0,5,5,0,7,7,2,0.777778,0.857143,0
sherpapeak,sherpapeak,,6,0,5,5,0,5,5,10,0.174874,0.207351,0
AyalaLluisa,AyalaLluisa,,2,0,9,9,0,10,10,9,0.206845,0.255306,0
CDRCerdanyola,CDRCerdanyola,,7,2,3,5,2,4,6,12,0.138683,0.164163,67.466667
Lolasevaalospu1,Lolasevaalospu1,,2,12,0,12,12,0,12,0,0,0,0
ganocat_og,ganocat_og,,2,0,5,5,0,9,9,1,1,1,0
CDRsLleida,CDRsLleida,,7,25,1,26,30,1,31,0,0,0,0
675_08,675_08,,6,0,7,7,0,7,7,10,0.193031,0.232124,0
mtrepa3,mtrepa3,,6,0,7,7,0,9,9,9,0.216575,0.256929,0
Votar32456286,Votar32456286,,6,0,5,5,0,6,6,10,0.177337,0.205301,0
blau_vent,blau_vent,,2,0,6,6,0,11,11,1,1,1,0
TeresaBordes,TeresaBordes,,6,0,9,9,0,11,11,9,0.221868,0.270154,0
Gemma51185456,Gemma51185456,,6,0,6,6,0,7,7,3,0.578947,0.727273,0
JosepMarcusCar1,JosepMarcusCar1,,2,0,7,7,0,8,8,8,0.235195,0.276692,0
josepaals,josepaals,,7,0,7,7,0,9,9,9,0.204713,0.239017,0
unitatperlaind,unitatperlaind,,2,8,1,9,9,1,10,0,0,0,0
DavidGR1714,DavidGR1714,,6,4,4,8,4,4,8,9,0.186613,0.213312,1766.65938
jmarchn,jmarchn,,7,0,5,5,0,13,13,12,0.126126,0.150933,0
CarlesSantacruz,CarlesSantacruz,,2,31,2,33,31,3,34,1,1,1,790.5
bergista1,bergista1,,4,0,6,6,0,7,7,9,0.215444,0.252993,0
CATaronja,CATaronja,,2,0,5,5,0,5,5,1,1,1,0
rmnahar,rmnahar,,5,5,0,5,5,0,5,0,0,0,0
jlcleries,jlcleries,,6,72,3,75,72,4,76,1,1,1,817.238276
ercdonesbcn,ercdonesbcn,,5,5,1,6,7,1,8,2,0.6,0.666667,25.5
LlibertatCat_,LlibertatCat_,,6,2,6,8,2,6,8,2,0.857143,0.916667,3.5
Isamn31,Isamn31,,4,2,3,5,2,3,5,9,0.230576,0.263757,13227.166219
tonialba,tonialba,,1,1,4,5,1,4,5,2,0.833333,0.9,58.299206
rulofree,rulofree,,1,1,4,5,1,4,5,2,0.8,0.875,0
ARKAITX14_4_69,ARKAITX14_4_69,,2,0,9,9,0,17,17,10,0.182117,0.223202,0
JavierP27960938,JavierP27960938,,6,0,5,5,0,5,5,9,0.222848,0.254596,0
albertrequenal,albertrequenal,,5,0,6,6,0,7,7,10,0.180574,0.213605,0
Antoni_Mallorca,Antoni_Mallorca,,6,0,6,6,0,7,7,2,0.8,0.875,0
_amengual,_amengual,,6,0,5,5,0,5,5,10,0.175949,0.205082,0
lickiwicki,lickiwicki,,6,0,6,6,0,7,7,11,0.157476,0.189776,0
jadellamoros,jadellamoros,,6,0,5,5,0,5,5,10,0.182237,0.216038,0
GuifrePpcc,GuifrePpcc,,6,0,5,5,0,6,6,13,0.119333,0.139968,0
darty016,darty016,,4,0,6,6,0,6,6,9,0.204412,0.244103,0
Aurora_Madaula,Aurora_Madaula,,6,162,1,163,162,1,163,1,1,1,457.842063
MolonsAntoni,MolonsAntoni,,6,19,8,27,19,8,27,12,0.138,0.177354,2328.11381
noecat78,noecat78,,6,4,5,9,4,9,13,10,0.176884,0.203676,28.863095
Rafa9591,Rafa9591,,1,24,6,30,26,7,33,9,0.187373,0.217508,11563.52601
RosaCB12,RosaCB12,,6,0,10,10,0,12,12,10,0.181226,0.226407,0
Starkenbergg,Starkenbergg,,7,0,5,5,0,10,10,11,0.165176,0.199857,0
carmemascarell,carmemascarell,,6,0,9,9,0,10,10,13,0.123501,0.164725,0
ifontmartin,ifontmartin,,7,0,6,6,0,7,7,11,0.153465,0.18056,0
botifarrax,botifarrax,,6,8,1,9,8,1,9,1,1,1,17.035714
TargetaVermella,TargetaVermella,,7,5,0,5,5,0,5,0,0,0,0
cdrsalt,cdrsalt,,7,6,1,7,6,1,7,0,0,0,0
smujal,smujal,,7,0,8,8,0,13,13,15,0.093047,0.126044,0
damiacalvet,damiacalvet,,6,17,0,17,17,0,17,0,0,0,0
LloberAngels,LloberAngels,,6,0,5,5,0,5,5,9,0.191065,0.22319,0
D595201543,D595201543,,6,0,6,6,0,6,6,10,0.176209,0.209442,0
totiapm,totiapm,,6,0,5,5,0,6,6,15,0.09157,0.111556,0
margasl1,margasl1,,6,0,6,6,0,7,7,15,0.091661,0.114621,0
XVila72,XVila72,,6,0,5,5,0,5,5,10,0.17565,0.205737,0
lakhlave,lakhlave,,1,3,2,5,3,2,5,1,1,1,4.222222
Adanae78667478,Adanae78667478,,2,0,5,5,0,6,6,10,0.173777,0.205871,0
mpgmuret60,mpgmuret60,,6,0,5,5,0,5,5,15,0.092364,0.116495,0
boiraintensa,boiraintensa,,6,0,6,6,0,7,7,13,0.12193,0.15625,0
MoraloJavier,MoraloJavier,,7,0,5,5,0,8,8,13,0.123937,0.152401,0
ManelGinesBiels,ManelGinesBiels,,6,0,5,5,0,7,7,10,0.201012,0.236497,0
MasRaimon,MasRaimon,,7,0,5,5,0,9,9,2,0.857143,0.916667,0
Solmare6,Solmare6,,6,0,5,5,0,5,5,9,0.220635,0.261461,0
diegocrespo2,diegocrespo2,,4,0,5,5,0,6,6,8,0.230258,0.264668,0
NoHiSomTots,NoHiSomTots,,7,0,6,6,0,13,13,9,0.203527,0.235389,0
Mario73078984,Mario73078984,,4,0,5,5,0,5,5,9,0.199424,0.228203,0
mariapilarserr1,mariapilarserr1,,6,0,5,5,0,5,5,4,0.555556,0.708333,0
enricsimoferre,enricsimoferre,,6,0,5,5,0,6,6,14,0.100801,0.124613,0
ECCEHOM54355458,ECCEHOM54355458,,2,4,1,5,4,1,5,12,0.13417,0.147747,278.2
poblescatalunya,poblescatalunya,,6,3,2,5,4,4,8,1,1,1,0.5
ramon_sans,ramon_sans,,7,0,5,5,0,6,6,2,0.857143,0.916667,0
r4m0ntt,r4m0ntt,,6,0,5,5,0,6,6,9,0.190117,0.217211,0
MatildaNes,MatildaNes,,7,0,6,6,0,9,9,13,0.129536,0.172514,0
AngelTorresSnch,AngelTorresSnch,,7,0,6,6,0,10,10,10,0.158648,0.183422,0
rosabass,rosabass,,2,1,4,5,1,5,6,11,0.152739,0.178685,92.028247
v_canadell,v_canadell,,6,0,8,8,0,8,8,2,0.9,0.944444,0
BSenespleda,BSenespleda,,6,0,5,5,0,6,6,12,0.132409,0.162276,0
vickycb65,vickycb65,,7,0,6,6,0,13,13,3,0.571429,0.708333,0
RABAL48,RABAL48,,6,0,5,5,0,6,6,3,0.666667,0.791667,0
ponscollaleix,ponscollaleix,,6,0,6,6,0,6,6,11,0.148925,0.183451,0
usvolemacasa,usvolemacasa,,7,142,0,142,249,0,249,0,0,0,0
Llibertatcat,Llibertatcat,,7,297,1,298,640,45,685,0,0,0,0
ADIC_TES,ADIC_TES,,7,68,2,70,95,2,97,2,0.75,0.833333,363.725541
v_rovira,v_rovira,,7,21,0,21,36,0,36,0,0,0,0
albertbatet,albertbatet,,6,150,1,151,150,1,151,1,1,1,17.703268
elpuntavui,elpuntavui,,5,5,0,5,5,0,5,0,0,0,0
PortuariosBCN,PortuariosBCN,,6,27,0,27,27,0,27,0,0,0,0
UndeLleida,UndeLleida,,7,0,5,5,0,10,10,2,0.777778,0.857143,0
VernetAlfred,VernetAlfred,,5,0,5,5,0,7,7,3,0.588235,0.716667,0
Besaluddelsud,Besaluddelsud,,6,3,4,7,3,4,7,1,1,1,8.833333
francescabad,francescabad,,6,7,2,9,7,3,10,1,1,1,5.166667
resonanciasocia,resonanciasocia,,7,4,1,5,4,2,6,1,1,1,2.916667
RevistadeCat,RevistadeCat,,2,6,0,6,6,0,6,0,0,0,0
flandes_i,flandes_i,,3,7,0,7,9,0,9,0,0,0,0
ggthebrauxxx,ggthebrauxxx,,6,0,5,5,0,5,5,1,1,1,0
GemmaPasqual,GemmaPasqual,,7,4,1,5,4,1,5,0,0,0,0
nacho_rull,nacho_rull,,6,5,0,5,5,0,5,0,0,0,0
intermon2004,intermon2004,,6,0,5,5,0,5,5,10,0.172801,0.202998,0
14Antoniom,14Antoniom,,4,6,4,10,6,4,10,9,0.219048,0.257839,7148.234859
nautic2050CAT,nautic2050CAT,,6,1,4,5,1,5,6,9,0.224838,0.260931,0
jnadalcanto,jnadalcanto,,6,46,5,51,46,5,51,12,0.131931,0.158939,6845.827549
joanignasielena,joanignasielena,,7,9,0,9,9,0,9,0,0,0,0
musicspenedes,musicspenedes,,7,4,2,6,6,4,10,1,1,1,1.5
avisiaviesreus,avisiaviesreus,,7,14,0,14,19,0,19,0,0,0,0
marianjubany,marianjubany,,2,31,1,32,31,1,32,1,1,1,4.95
lluisgpera,lluisgpera,,6,4,1,5,4,1,5,2,0.666667,0.75,4.366667
perellonet,perellonet,,2,3,2,5,3,2,5,2,0.6,0.666667,3
DamesxRep,DamesxRep,,3,6,1,7,6,1,7,14,0.100725,0.1144,323.5
BatallaCarles,BatallaCarles,,6,14,2,16,14,2,16,10,0.160558,0.177171,3801.090598
pmenamendoza,pmenamendoza,,7,0,5,5,0,9,9,11,0.153463,0.179122,0
chdauriac,chdauriac,,6,13,1,14,16,2,18,0,0,0,0
ZahiaGC,ZahiaGC,,7,9,1,10,9,1,10,0,0,0,0
JuntsPerCatBDN,JuntsPerCatBDN,,6,5,0,5,5,0,5,0,0,0,0
ANCLHospitalet,ANCLHospitalet,,7,7,0,7,7,0,7,0,0,0,0
novulltwiter,novulltwiter,,2,14,0,14,14,0,14,0,0,0,0
mstrubell,mstrubell,,6,9,1,10,9,1,10,1,1,1,0.75
jpoubaez,jpoubaez,,6,9,0,9,9,0,9,0,0,0,0
AccioxRep,AccioxRep,,6,14,0,14,14,0,14,0,0,0,0
IsraelGJS,IsraelGJS,,1,5,0,5,5,0,5,0,0,0,0
nunulona,nunulona,,6,17,0,17,17,0,17,0,0,0,0
ecasajoana,ecasajoana,,6,11,0,11,11,0,11,0,0,0,0
E_Gallinat,E_Gallinat,,7,9,0,9,9,0,9,0,0,0,0
mariona__rull,mariona__rull,,6,11,0,11,11,0,11,0,0,0,0
martikarreras,martikarreras,,5,6,0,6,6,0,6,0,0,0,0
Vinotava,Vinotava,,3,12,0,12,12,0,12,0,0,0,0
soniacuadrat,soniacuadrat,,6,5,2,7,5,2,7,1,1,1,43.181746
Itxarobi1,Itxarobi1,,4,0,12,12,0,16,16,8,0.255535,0.30915,0
